"""
mmmmmmmmmmmm
m..........m
m..........m
m.....f....m
m..........m
m.......p..m
m..........m
m..........m
m.....c....m
m..........m
m..........m
mmmmmmmmmmmm
"""