9 3
38 156
111 138
105 0
23 81
15 120
63 57
71 44
31 70
20 128
011010111111010111110111111011011111111100111111111111111111a111111101111a111111111111111011111111111111011110a1111111110111111011111011110011011111111111111101
001101010111101110110111110111011111111111110111101110110101a111101100101a101111111011111111011111111101010111a1111111001110111110111011111011111111010110110110
111111110111101111111101001111001110111111101101111111110111a110111011101a011111111101111011101101111101110101a1011011111111111111011101111111111110111111101101
111101101111111011101111111011111111101111101111111101010110a111010111100a110111110101101110011111011110111111a0101110111011111101111101011111111111111111111110
101010101110111001111111000111110000111111011111011001110111a111011111101a111111111110111111111110111100101111a1111010111111111110101101110111111111110111111111
101111011111111111111101111111110111100100011001101011001101a011101111111a111111111101111011111111100111011111a1110010101111111111101111111111111111011101111111
101101101010101111100011111111101100111111010111110100111110a011011111101a111101110111111101111111111100010111a0110011101111101011111111111111111101111111110111
011000111111111110011110011101111111111101111011111110111111a111101111111a110001111111111011011110111110011111a1110011111011111111111011111101111111110111000101
111111111101100101111111100111111011111111011101011110111111a101001011111a101110111111101111111110111111111010a1111101101111100100110011111000110111111111111101
101111111111111111010110111100111011011011110111011111101101a111111111111a101111111111111101111101111101011111a1111111111110110111111111111101011101111011011111
110010111101111110111101011101111110011111110111111011111101a111111101111a101111100111111111011111011111011100a1011110111011111111101111111110101111110111010100
111111111111011111111111111011111110111101111111110111110111a111111110011a111001011111111101100010111011101110a1111111111001001111111011011111111111100101111111
011111111111011111111111110011111110010100111111011101000111a110111011111a010011111101111111110111110111111010a0111110111111011001110111111110101010111010011101
111111000101110011011111110111111110101111011101011111001111a010110011111a111111111110101111111111111011001011a0111010111111100110111111111101111101101110110111
111110111111101111111111111111101111101111111111111111011111a111111111111a111111111111011111111111011110110111a1111101111111111111111111111111111111111101111111
110111111101111111011101111011011111110111111111111110101010a101111101111a111110101111110101111101101111101010a1111111002212222201012221211221122202102111011111
111111111110011100111001001110011110111001101000111111111111a011101000101a101011111111111111111001101011011000a1101111112120100122212222112221222011011011111111
101111111110111110001111101111101011111111111101111101110111a111111011111a110011101111101111110111111111111011a1111111111222210001000221021112122221102111111111
111111111111111111111110011101111101111111111111110111101101a111111111111a111101111111111111010111110111111101a1111111112212120222122012212111122121121110111111
111111111011110111111111110011111101011110101111111011111101a101011010110a101110111001001110111110101010011111a0011011110120122122202112222112120121220111111111
111111011111000111101111111111111011101110111111011111111110a011111101101a101010111100111111111111101111100111a1111111111202221211121221120212220121211212221101
110111111010111011111111010111011111111111110111101111111011a111111111111a101111110011111111011110111111111111a1111110101212111121210201122211211221112210221011
111100011111011111110111011011111111111111111001111111111110a111111110111a111111111001011110011101010111011111a0111101112111212221212121221101221011210221121021
111111010011111110111111110101111111111110011111111100111111a111111101011a011110110011212211202111221212011212b2011101110021001211000211002120112112110012222211
011011101111111011101111110110111011001111111110111101111111a111111111110a101111122122020212111220222100012220b2100110111122222122010010221101022111211221222111
110111111110101101111111111111011111111010111111111110111111a011111111111a111111120112220201001200222101101121b2111111102210021220220212111111001221111011021110
111111111101011111110111111001111110111110110111101011011011a100111111011a111001111202220221122100222211221012a1110111101221222101012110021211110211222221022121
111111101101111111111111111111001111011111101101111011101111a111111110111a001111101202122121222111202112112222a2111111100211222221122121212120111120220011211211
111101111010111110111011111001111111111111111011101111111111a111111110101a111110012121200201112112022211012111b1111010011120220222202212112212102002111210012021
101111110111111001101111111000110111100101011100111111110111a111011011111a100111022120101212100111212221021121b0111111101112020201020112111012111211210121221211
111111111110111111011101011101110010111010110111111111010001a010011010011a111110012110201211121121120220202122a1001111110122112121112020022122210012012220202111
111111110111011101111111111111111111111111111011101111011111a111011111101a212121102021222012222201202022111111b2111011111021121221121112101201221111211212012200
111111111101110111101111110001111111110111000111111011101111a111111111112a112120011111211121211201010222021111b1111110102211211121221111222111221111111220201221
111101011010011111110111111111111111101111111111111111110111a011111111211b121011201221122120221122212011210112b2111111010011010221020111121111122112111121211211
111111011001111111000101011111111011111110111111010111101111a111010111212a121212012220022121010102102211121120b2001111011122121122202121202210221220200121211221
111011111011111111001011111010111111011111011010011100101110a011111111201a022022222220201010211212120102221110a2111101011022222211221102012110211211100212111121
111111111111111111111111111101111111011110101111111111111111a111111111101a212022011222111200112112222221021222b2101111112211221021202122112102122222221022221211
aaaaaaaaaaaaaaaaaaaaaaaaaaaaaaaaaaaaaaaaa1010111111111111011a110101111102b211111220112010212200121201201220222b2110111111121202101211211011112221222120111110211
1101011111111111111001110111111111111111a1111101111111101101a111101111210a112122101021202021220122100102212222b2111001111212012110121112100222212221212220221010
1111111111101111011111111110111111111111a0110111111111111111a110111100111a101112122111221211020122222221122112b2001111111121212212212211221112102221021211220121
1011011111111111111011111111111101110011a1111111111111011111a001110101021a110021112222022222221110221222200102a2111110111012011211011212101022110122111202022221
1011111111110111110100110101111111101011a1110111101110101110a111011111011a102201111122201221120020202122011220b1110111110212121121202111221222222021111110212121
1111111111110111111101111110001010101011a1111001111111111111a000011111000b000112202211221122122111211021221210a1111011111221111111221211010201102222211101210221
1111111111110111011111110111100111111101a1111000101011111111a111111011121b211112222220212022020122220210212221b2111111102120122121201211222211121211012122101010
1111111111110011100111111110111111111111a1111111110111111111a111111110121a101012220101122110212212002100222211b0011111112111022101022201222121222110022122222121
0010011011011110110110111111101111001000a1111111110110111100a111111111020a112221022012001212022111122021212222a1001110112121012212121121101201211221111101212101
1101111011111010111101011111111101111110a1110111011111011111a110011011020b122011120222212122112111111221012212b1101111111111111010211101111011112212111200211100
0111111111111111011111100101011111110111a1111111111111111111a100101101201a222222220112120110211222110211022222b0101111110110110121122222101112222112102122212111
1111111011011011111111111111111001111101a0111111111111111101a111111111211b212111111211012121111121220221222112b2001010111111110101121212112121110221211111220120
0001111011011101111111110101011001111110a0100110111110100111a111111111211a212110012202211120001211201121221120b2111010101100000112220122002012202211211122221211
1001111101101111111011011101111111010111a1111111101010011111a101110110210a120121222212102022112222021121210212a2011111111110111111211002222210110112211101010021
1101111011111011101110111110111110111111a1111111110100001011a111111101200a121122221012111202222110122122220201b1111111101011111011101111101110101111110111011111
1011111110111101111111111111011111111111a0111111001110111111a011101111011b101221222021200111200111221100020220a2111111111011011111101100011111111110110111111111
1111010111101111111010100111110111011111a1011110111111101111a101100111212a220012211110210220110222111121202101b1111011111111111110100011100111111110111111111111
0010111011111000111101010100111101011111a1110111111111011001a111101101011a210211012111112212022021012111111101a1111111111111111110111111011111101111100101111111
1011111100111111111111011111011111111111a1111110111111111111a101001111101b210202201002212221122020021111111101a1101111011111010111111101111111111111111011000110
1110111111111111111111101110111111111101a1111111111111100111a011111011221b122021212020200101211212201101110111a1011110011111110111111011111111101111111011111000
aaaaaaaaaaaaaaaaaaaaaaaaaaaaaaaaaaaaaaaaa1011111111111111111a111111000100a212020102121120110122021222111111011a1111111101111011111111111111101111011111001011111
011111111110111100111111111111111110110001011110011100111110a111111111111a121101111222211221122012021111011111a1100101111011110111111000101111101111111011111111
111110111111101001111111011000010001111111110111111101110011a011111111211a112221201121120221002212122010110101aaaaaaaaaaaaaaaaaaaaa11010100111101101111101011101
111011011111110111011101111101111111111010111011111110111101a110110111221aaaaaaaaaabababaaaabbbaaabaaaaaaaaaaaaaaa1011111111111011a11110101111101111011001111111
010101111101111111011011110111011111111110111111100111111101a1111111110012110201112022112221221120012111110011011a1111111110111101a01111011101111101111111111101
111011101001110011101111111111110011111111011110111111011111a0011111111111110111101111101111111010011111111111111a1111110101011100a11110101111111111101011111011
110111111011101111110111111101111111101111111111001110110122b1101212110110120011221210101111111111111111011101111a1111111101101101a11111101101011111111011101111
110111111010111011111111111011111011111111111100110111111110a2112222211211220112201121021110111101101001011001111a1101111101110111a11111111111111111110011111111
111101111101011111111111110110100111101111001111111111111112b1211110111102002121222202111111111011111101111110110a1111111111010110a11111111011101011110001010111
111111111011111111111011101111101100111110110011011111111221a2011200110012120111112102211010011111101111111111101a1011101110111111a10101111111111111111110101111
011111111110001101011111011111011111111111111110011111110112a1111020001202121112102121121111100111110111101110111a1111111101011110a10111111111111101111110101111
111111111011110111110111100010111001001111011111111111011122a1112210022222120111221020101111111001111110011110101a1101111111111111a11100111000001111111111011011
111111111111011111011111110111111110111111111111010111000221b2211212122122100111111212221110111011111111111111110a1110110111111110a11111101111110110110111110111
101111111101011010011111101111110111111111011111011111110212bbbaaaababaabbbaaaaba21101211011011111011111100111111a0011011011111111a01010101111011111110011101100
01101111110111111111111111111111111111111110222111122122121100112122222120122222a01221220010101101110111111111111a1111111111111111a01111111101111001111000111111
11111110111010101011111110110111111011010101122012110211120211021010111022212122b11121010101111111111111111111101a1011111111111111a11111111011111101111111111111
11111111101111111110111111111111010110110101101211122201002022212211221112101122a21001221110111011111111111011101a1110111101111110a11010111011110111101110111110
11101111011101111110111111111111111101111111022220101000222200212212210122121112a12112110111111011111111110111011a1100110111101101a11111111111011101011111111011
11111001111011111101111111110111111111111111211222121110020221102021100101121212b20112011110111010111111111101001a1111111111111110a00111011111111011111111111101
11111011101110111111110111111111111011010110110111212222212122111212212222112122b12122221111101111111111111110011a0111111101011111a11111111111011111111010011111
11111101111110011111111111011111011111111110010201122221222012101011021210210202a21101111111110111111011111111111a1111111001111100a11111111101101111111111001101
11101111111111111110111111111111111111111111001102112002211011110020011112112121b21211111111111110111111111100111a1111111111111111a11010111111111001111011111111
11111110101111101101110101110110011111111111022122222210221110220021222200222111b01202220111111001001011111111011a1111111010101111a11111111111111101010100111011
01011011111111100111111110111111010110111110101220220110112221101111202212021122b21201021110110111111101001111111a1111111111101111a11111111011011110111111111011
11111111111111111110101111111110111111111101201110212202212212221200101222121112a11020211001111111110111111010011a1101111000111111a11100011111111011111111110111
01110110111111011111111111111111001011110111112100211102122211222221111222010000b11212110111111111110011111111111a0111011111111111a11011101111111111111111000101
10111111011111111100111111111111110111110111002122011221122022021101122102101222b21020121110111110111111011011111a1101000111011010a11101111111011111011101101100
11111111111111011111111110111111111111001011220221001210011011111221111221220021b20211211111001011111111101110111a1101100111111111a10111111111011101001111110101
11111110110110011111101011011101110111110101010111210122212111112110101121211221a01120111111111111111011111111010a1111101111111101a11101110111111111111011111011
10110101111111111111111111111111111100101111222200010111121222102221211221211122a10221220001111111111011111010011a1111110101101111a11111111111111011011111110111
11100111111011101110111101111111111110111100100021112112112212212201112221022212a00110220111111111111111111111111a1111110111111111a11001111101111110101111111110
11111111111111110101111001111111111001101101212012211022210111102220212112212201a10110021011111111110111100111111a1111110111111111a11100101111111011111110111101
11111101101111101011110111110111111111111111111020120221111200211211100202211212a12102101001101111011111111101110a1111111110111111a11111101111110111111111011110
aaaaaaaaaaaaaaaaaaaaaaaaaaaaaaaaaaaaaaaaaaaaaabbabbaaaaabbabaaaabbaababbbbbbababb21201210011111111111111110111111a1110011111111111a11011111111011111111101100111
11011011110111111111111101111011111101101111022111212212121012012212102202102210222101111111111111111101111111110a1111111111101111a11011111111110111110101111111
11111011111011111111111111111111011111111111202222201212111110002122011112222210120022221010111111111101101111011a0111111101110111a11101111111110110101010001111
11011111111110111111111110111111111010111111112200001221221121021110122112121212222121221111111011111011111111011a1111011101001111a11111111101111111110111111111
10111111111010110111111111111111111101101011122220211211111202021222121211201111111001111101011111111111111001111a1111101111111111a11111011110111011111110110101
11111011111111110111110110111111111011010111112220112220101011120221122112000111011011111111011011111101100111111a1110111101011111a00111111011011011111111110111
10111110111001101111111111110111110111101011112112211111202012112222122012001111111111011111111111011111111011111a0101111111111110a11111110011001111100011111001
01111111111011111011111111011110110111101111220212200122201221112020211112000011111100011111101001111011111111110a0010111011111111a11110111110111011100111001111
11011001111111111111011111011111111101101111210111211012101121012120112110111111111101111101000111010111110011111a0111111110011110a10110111111001111111111111110
11001110111111110110111101111111111111111111122020211211202122110020212102211001111111110101111001111101110111111a1111110011111110a10111111011110101111111111111
11110110111101110111001101111101111111011111022210221200211220221021111010210101001111101011111111111110011111111a0111111111111101a11111111111101111111111110111
11111111101011111111111111110111110111111111222222220112122101112212211121111110110011101111111110001111111011111a1111100111011111a01111101111111111110111110111
11111101111011101111101110111111111111111111111111111111010111011110011111111111100011111111111110111111111111111a1111101011111111a11000111111011111111111111111
11111111111101110010011111111111111111111111010111011111011111111111110111101001111111111111111111111000111111111a1111110010101011a11110111111110011111111110001
11111110111110101111011110011110011111111110110111111111111111101011111111101111111111111101111010111111111110111a1111111111111001a11011111111111110011111111111
22111121222102200122122121101110011001111111110111110111101111111111111110111111111111001111110010111111111111111a1000111111101111a10110010111111111011010000111
22112101020210202122101111012211111101011111101111111011110111101111111111111101110101111000111111101111111111111a0110111111111111a10111110111100101110110111100
11111011111011110111011111111011111111111110010011111101111111111111111110101110111111101110101110111111111111110a1111010111111101a01011111101111011111001111111
12221102212221101211111112102111100001010101011101110111111111111111101101111111101010111111111101011110111010011a1100111110110111a11110100111111111101111101001
22111011111210222110112111111021111111111111111111110111111111111111111111010111110111110111101111111111101111110a0111101101011111a11011111110111111111011110101
21121212222021021211011211101201111111101111111111111111011111111011111110011101110111110011011111111111101010101a1111111101111111a11111111111111001101111111111
01112220222211201011112222201220111111111111111111111110101111011111011100011111111111111111101011111100111110110a1101111011111111a11111112112110122222222122222
01211012020002110120220210021121111011111111100111011111100111110101101110111111111101001111101101110111111111111a0111110111100111a11011111110112120112101220221
21212221121122212110112011101021011110011111111111111110001110011111111101111101111111111111111101001111111000110a1011111011110101a01111112110121111221211100022
12101121022121021112111210202201111011110111101111111111101111111111111111111111111111010110110111010111101101111a0111111111001111a11110111122102212012212120211
22102010101122222222212212222200101111111111101111100111111110111111010111111001111101111110110111110111111110101a1111010011111111a11111100221222020202221012220
21211201221200111211212100021121111111111111111011111111111111101111001111110011111111111011110110111111111100011a1101000111111111a11111101121112222102211020112
22111120001102222101122212222121111110110100111111010111111111011111111110111011110011001111010110111111111101111a0111111111011101a01011102211122211002101011111
12121221220011111222011110022200101110011110111111110101101111010111110110011111011110111110111111111110001111011a1111111111110111a11111112222011211121222211220
22111222011120221221020110210121110111111111111111110110111011000111011110111011111111111011110111000111111111111a1011111111111111a11111111121101212201110111121
