38 2
101 38
57 119
87 46
45 130
71 88
84 55
41 159
17 68
80 143
1111111111011111111111110a1011110010111111010a1111111110111111111111111001111111111111101110a1111101111001111111001111a11111010101101111111111110111111110111011
1111111111011011011111111a1100011111101111110a1111111111110111111011111010111001111011111010a0111111111111111100111111a11011010111111110101111010111011111111101
0011010101111101111111111a0111011101111111111a1111101011110111111110110110111101011111111101a1111111100111001111110101a10111011111111111111111111101111011001111
1111011110111111101111111a1111111111101000111a0111110111101111011111011110010101111111111111a0111010110111110101101111a11110111101111111111111111111101111111111
1101111011111101001111111a0111010111011111111a1111111111110111111011111010101111011011111111a1010101011110101111011111a10111111111101101111111111110111111111111
1110111111111110111110010a1111110111111110011a1110111101111111111111111111101110111111110111a1111100001111111110001111a11111101110111011111111111111111100011111
0011111101111111110101111a1111011111101111011a1110101110110111111111111111110010110111101011a1111001011111111110111111a11111010111111100110111101111111111111111
0110111111111101111110101a0101111110010111111a1111101011010111101111111111111101111011011111a1111101010100011111110111a11111100000101011111001101111010111111111
1101101101111111111011111a0111010111110111110a1111011101101101111111011111101010110111110111a1111011111001111111111111a11111111111111111111011101100111111010111
0010101111111111111111110a1110111111111111101a1111110111110101111001011111111111111111011111a1101101101110001111111101a11100101110011111111101011110111001111111
0100111100111110101011110a1111101111111111111a1001111111111111111011111111111110110111101111a0111011111111110111110111a11111111101111111011111101111100101010111
1111111111110111111111011a1111101010101111101a1011101111011101011111011111001111110111011011a1010001101101011111011111a11111111011111111111111010011011011111111
1111011101101101111111110a0011110111111111111a1110111111111111100111001111111101110111110111a1111111111111101011110111a01111110101101011111110111111111111101111
1111110111111111110110101a1111111110111110111a1111110111101110101111110011111111110111111011a1001110111111110111111111a11111101111111111110111111111111111111011
1111111111111011010111111a0111111111111011101a1011011111111111111111111101111001110100110111a1111111111010101101010111a11111110111011010101111110111111111101100
1001110111111111011011111a1110111111111110111a1010111111111111101011111110101111001111111111a1011111101111111011111101a11111100111111111011110001111111111111111
0111101101111111101111101a1111101111111011111a1111111010111011111110111111111111111111111110a1111111111011111111111101a11010111111011010111111111111101110111111
1111011111111110111101111a1111111101110111111a1111111111111111110001111211211121110111021102a1121011111111111011011111a11101111111110111011111111011110111111111
0110110100100111101101111a1110110001111111110a1111010110111101101111111121001221101201011121a1222211001011111111111001a11111101111101111111101101111110111110111
1111101101111110011011101a1111110111111110110a1101111111111101111101201121110111112012201002b1122210111111110011100110a01100111111011111101101110011111111011000
0111110111101111111110111a1101111111111111111a0000111111111111111111111111111111101111001101b1212011101111111011111011aaaaaaaaaaaaaaaaaaaaa101111010111101101111
1101101010011011111110011a0010111101111100111a1011110110101011111111211220111202121111111112b011212111111101100001100111111110111111111101a110111111011111111001
0111111011101101111111011a1111111111111111111a0011111111110111111111211121200112122112012212b211101111111111111111111111111001101111111111a111111011111110111111
1110011111111011110111111a1111111111111111011a1110111111011101111111111021101121212110111111a201122100001011100101110111111111111110111111a111111111111110111111
1111111001111111010101011a1011110111111111101a1111111110011111011111102220211222021212222221a102220011111101111110111101011110111101111111a100111111111111111110
1111110111111111111111111a1100011100101111011a1011111111111111101110112121011021221200002210b112112100111111111101110110111001111111110110a101011111111110111111
1110111111101111110101111a1111011011111111010a1101011111111111111110111111111122022111022100a211100111101111111101011011101001101111101111a011111111100011111101
0111111101011111011011011a1111111111101111111a1111111111111011111101111201011202202201111121a121111101111011111111111111111011111101111111a011111111111110111100
0110101001100111111111111a1011111111111111111a1101100101111111111111111121111011201100012211a212222110111111111111001111001101101111111100a101011111011111011111
1011111011111111101101110a1011111101011011111a1110010010110111111101211120210222122111111112b221221111111111110111111111111110111011110101a111011110110011010110
1111111111111111011111111a1111111111111111111a1111111011111111011101212021110010112210111122a020222111111111111110101111011110111110001100a011100111101101100101
1101111011111111111111111a1011111111111111011a1110111001011110110111101011211212121212110222b022002111111100111110011111111101011111111110a110010110110111110111
1011111111101100111101111a1111111111111111111a1111111111011111110111112111210221101202001110a001011100011111110110101111111101110010110111a111111001100111100110
1101111111111111111111101a1110110111100011011a1111011111110111111111211201110202202112121022b021101111110111100111111111111111111111001111a011111011011110100111
1111111111111110010001101a0111110101110111011a1011011010111101111101210201111122022012221022a120222011111111111111111110010111111011111111a101111111111111111101
1111111111110110111111101a1101111111111011111a1111111101111111111111010121211222201101000211b221212111110111111111101111111101100011011010a111111110111111100111
1110110111101111101111111a1110110111111111111a0100101111101111111110111120011022021111222122b111012111011111101111111111111011111111011111a111001111111111111111
1111111111110011011010111a0111011111111011110a1110111110111011111111110111210112101111211202b012021110111010011011001111111111101111111101a111011111011010111111
0101111111111111111111111a1111111100111111111a1111101011111111110011011101201012222111110102a212210110111111111111010110101101111011100011a111101111011111011011
aaaaaaaaaaaa1111111111000a1111101111111111110a1101111010111101011111202211211221201112021222baabbbbaaaaaaaaaaaaaaaaaaaaaaaaaaaaaaaaaa11101a100111111011111110011
11111011111a0101101111111aaaaaaaaaaaaaaaaaaaaa11111111110110111111111110102011110010111011111111111110110111111111110111111111011111a11110a011010100111101001111
11111101111a101111001111111111011111101111111111110111011101111110112111222112111102011211122101110011011111011110011111011010001101a11111a010111111111011111111
11111010101a011110110011111110011110111101110011111101111110110110110122101211212221101122222211112110101010111110111100110101111111a11110a111111101111111111110
11011011101a111110011100011111111101111111011111110110101111111111112111112111022210121122100212011101111111111111111111101111011110a11101a101111101001111111112
01110111011a111111111110111101111111111011111101111111110111110111102012102202012212012022120102220111111111111100011101101011111111a10111a110101111011111111011
01100111010a111111011110111111111111111111111110111111011001111110011122211210022102121220111120220111111111111111101111111111110120b10211a010200011010210210222
11110111111a101000111111111111111110011111111100011111001111110111111122012111121111110212020212220111111111101111101111111101111112a10202a121021121112112210111
11011111111a110111011111111111111110111111110111110111111111111101111112120011222212112021212221121101011101111110011111011111100112a10212a210112211210111111120
10101011101a000111110111011001111111111111101001011111111100111011111111110011111011111111111111111111111111111110010110111110001121a12110b221122111112212211111
11001111001a011101100111111111111111111111111110111110111011111111110100111111001111111011111111111001111110101111111111111111111112a00211b112210120200020211121
11011111101a111111111111111111111111111011111101110110111111111111111111110110111110011111111101110111111111110111111110111111110012a10012a112102210212212121122
01111111101a111111011111011110110111101011011011101111111111011110111111011011101111111111110011111100110111011111111111111111011101a01202a222122210212121201221
11111111111a110101111011101011011111011111111111111100100011111111011101111111111011100101111011101100111011111111110110111101011112a12210a222201121222020101122
11001111111a111111101010101100111101111111111111111111111110111100011011101010111101111100111110111110101110010111111111101111111121a11101a200212012211221221002
00111111110a110101111111111011111111111111101111111111111111000111010111101101101111111111011111011111111110111111101111101110110112a02220a211122111121211011011
01111111111a010111111101111101110110110111111111111100110011101111111111011111011111101111111110111111101111111011111111110111011112b22101b212001211112102120120
11111011111a111110110111111111111110111111011111111111110111111111111111011111101111101011111111111111111010111001011111110111111102b10202b221112100002222111111
10101111111a101010111111111111111110111110111111101111111111011011111101110011011111111110111111111111110111110111111001110221112122b21012a101212212112210200122
11111001110a111111011111110011111111111111110001111111011011001111111110101111011110111011111101110111111100111110111112201110111212b10212b212020020012111220122
11001101110a0111010010101111111111010011110101111111aaaaaaaaaaaaaaaaaaaaaaaaaaaaaaaaaaaaaaaaaaaaaaaaaaaaaaaaaaaaaaaaaaaabbaaaabaabbbb11111a122011102101122201120
11111101111a1110111110111101110111111111111111110001a1101010111111111101110111111111111010110111110111101111110111111111112021222202120022a210211111211111111221
11011110111a1101111101111010111110110110011110111111a1111111111110011101011111111101111111111111111110101011111111111112101011211120110202a221211011221212111220
11111101111a0011101011111111111111011111110011011111a1101111111111111111111111111110111111111111111010111011111110111110212020201021021022a201200111112021201022
01111111111a1111111011011110011111111110111010110101a1001111011110101111111110011011111111111110101101101001111101111011022221222112020212b120122220122021220121
11111101110a1111110111111101101110001111111111100111a0111111010111011111111100111011100111111111111111111110110111110111022221121121122111a222211201011012121000
11111110111a0111111011110011011111111100111101011101a1011111111111111111111111011100111111101101111110011111110110011112211202220201001111a011011110210010100221
10101111111a1001111111011011111011111001111111010111a1101111011110101111111101110111111111111011011101100101011011111100211201101122121211a112211222011001211221
11011011101a1111111101011111111111001111100111110010a0111111111111110111111011111111101011101111100010111111111101111112121222000210221212a221111220211122221212
01111100011a1110111100110101011110101011111111101011a1111111101011101111111111111111011111101011111110111111111111101112101211222121222022a112211210122101221112
11111001111a0011111011111111111110111111001101101111a0101111111111111001111111100111111111010111101001111110110111101112121212202111122122a112222222112121011212
11111111111a1111111110111111011010011101110111111111a1111101111111011110111111111111111101101111101001101010111111010111201222022212221112a110111012111122111221
11111110111a1011111011110111111111110011111111101010a1111111001111011111111101110111111111211212011220111101212012121221001111121111111112a011221212211211110222
11111111111a1010111111110110111110011011111101011110a1101111101101111110111010111111101022200222112110101201102002111222011121022021212201b102111022200201211022
11111110111a0101111111111111001011111111100110111011a1111110110011111111111111111111001102012221222210211221000221011122102112212011121202b011110221112121111102
11100010111a1111011110111111111111111101111111111111a1111111110010111010001111111111111120222011112202212022112212200211102110211102110101a222102100120021121002
11101111111a0110110111111110101110110011110111111110a0111101111001111111011100101110111111211122121121221020022212012022220210202101201102a011100111101022211122
01111111111a1100101101111110101111101111111111111111a0111111010111111101110111010111110111001212111012012122212010112011022211021111111020a122102110221110111111
11111111110a0101110111111111101111111111011111111111a1111111111111111111110101001111111111112020200121110122211222121012012120111121121121a211112000211101100110
10001110111a1111011110011111110111111111111110111111a1111111111111110101111111111111110111112220112020011221212012110110111121211120121121b202221211111111111100
11011011011aaaaaaaaaaaaaaaaaaaaaaaaaaaaaaaaaaaaaaaaaa1011011111110111111111110010100101101122111012022011221012212110112122021010222100021a120112101101110111010
110111111101111110111101001110111111011111111111111aa1011000110110111111111111111111101111011001022102101112211212222021000110210022221211abbaaaaaabaabbbbbaabbb
011011100011101101011010011111101111110011101111111aa10111110111111101111111111111111111200202220112011112122010211002222120122220222222202011122111211122001101
111111001101011110101110111101011111011110111111111aa11110111011110101111111111111011001210021121211021210010211200011121021120212121011112122110212111211220111
011111111111111101011101010111111111111101011111111aa10111111111110111111111011111011111120212222220120101112000122122210201122212221221111121022122102012211110
100110001110111111111110010011001001110011111111111aa00002121112022011121211210110001101012100221020222212011111122200022112002121211010121222212120012112210002
100111111110111110001101111111011111111101111011110aa01102002212210221012110222221202211201221111112121221022221100012120111112211122222120222110222102012221122
111111101111111110011111111111110111101111111111101aa11102021101212121012211112022122201211121122112102211212021010110211100112121012022101001220112210201022022
111111111111111111111111111100110101111011111011121bb02111002210112011111012222110122000110222210100112122120121112211112021202022212212022101121010210121221112
011111111110111111111100111111111110111111110012101bb22110120112211111111102122122020211121120022210112012122202110122011110110111111111111111111110111101221222
101101011111111111001111111110111101111111101110122ba22121222222212200220112202101121100211221222022212121212210001101111101101011111001101111112112201222020022
111011101101111110111111111111111111111111111111212ab21021112111220011002120221122112111022212122112121122121000111120110011101111011111110101121210211021110011
111111111111110111101111111110110111111011111012112ba11001012022021200222121012122121111022121212102222011102001022112211110111111111110011011111202112010122222
011111101111111111010111111101101110100111111001110aa22022211022121021121211200211211211120211102111211202112122112112211111111110111111111111110112011212112112
111111111011111101111111111101111101111011101111222ab21000010220001221010212220102211101221222220001021111122012002021011110011111111111111111010111212002201221
111101110011111001111101101111111111010011111012211ba20010211212021222021201222122021201221212100021112221221212122011010111111111101110111111022012211112012002
011111111111111111101111111111111111001011010102211ab11122111211110110210021100122021111010111112202102022101022101112111111000111111111110111121102111122121222
111111101110111111111110110101011111011101011112211ab20100211122212220021122121211112200121100111100011102222111221211011011111010111110111011112222212201021121
111111111111110110111011101111111111111101111122120ba21101121210201222221211212121012210020211022221101211121121222112211111111111111101111111111112212122102112
110011111111111110011111111110001011111011111100112ba02112210221201121222102120110000211101112101221100211111222101211001111111101111111011111121012111020221120
011111110111111111111111111100111110101000110122220ab21022010002110211110110011110111111101100111101101101111010110122111111111011111011111111111101112101121011
011111101111011111011111101011010111111111110011222ba12111221210212112220112102211122101211211112122221212121102111221011110010111111111110010122102112120001022
111111110101111100111110111110111111011111111011222aa01112110212002211222101010011020111101122102012021121011222222212011111101111111111000111120200212100021121
110111010111111111101111111101101111111111111122212aa21110122110211110121210120122121110111110111101001111111111001110110111110110101001111111102112112101120221
111011011101101011111011111111110111100000000021112ba01112211112112102121011111021010211010111011110111001110111111110111111111101111111111101122111210112201222
110111001111100111111111001011001100111011111122022aa01112110102201111211101122120011101111111111111100101110111110110111011110101111111111101121201200210111220
111111101111011111010111010111111011101110011121211ba11000200210220100222101212121011211111011111111011111111100111110111011101111101111111101112211212200221101
011111110111111101111111101011110101111111111122021aa10011010001112101112012112110112010001111011011111111011111101110110111010101101101111111122110202110221220
111100100111111101101110111001111110111111111101211bb00122201011222001222111112220002011011110111111001111111111111001111111101101111111111110101012110122111001
111111011111111111111010101111011110110111101122221ba11120102121112011100221011221021110111111110011011111111111111011011101010111111111111010102111010110211211
111111111111111111011001111101010010110111101122111bb11122212012222111221212012102122211111111111011111110111111111111111101111111111101111100111111210121010022
001111011111111111110011011111111110111111011120221ab00121201221221110202011110221212211101111101010110111111111111111011111110111111111111111121110212102101100
111110110111111111111001100111100111101111111022212aa12121211122020101211111112202111101111101011101111110111001111001111111011111111011111111111111111111111111
101111011110101110001010100111111011101111111122111ba12102200012111111120102110201212211100101111101111011011011101101111110111111111101111111111101111110011110
001111111111111101111111111111101111011111110121122aa22102221021201101101222122211011011111100101111111011111111110101111101110111011111111111111111010011101101
111111011101111001111111111111100111111111011110112bb12010121221111201102022112111112211111111111111011111111111111011111101011111111101100011101101111110111111
111011111110010111111010111111111011111010111111102ab12121122120022110111211211111100111101111111111111111111111111111110101111101111111111111100001111010111111
110011010111111101110110111111001111111111111121002ba10010222012102112001101211101111101011110111111111011111111111111011110111110111111111011111111110110110111
101111111101011111110111111100111111111001111110211bb11122101122212111221021111111110101110111111111110111110111111111111111110110111101111111011111110111111100
111001111111111111101111100111100010111100111111100aa11111011101010110111101111101111011111111111101111111011011111110111100111101100111011111111110111111101111
111111111111101111111111111111010111111001111111101aa11111111111111111111001111100111111111111011101111111111011011111100111110111110111111110011011011111111110
