2 159
112 141
87 94
63 80
46 79
85 61
30 110
8 59
5 107
69 159
1a11011111011111111111111101111011011111111010111111100111111110100011111110111111011111010101101011110111a11111011110111101110111110101101110010111011111111110
0a11111110111011111111101110111111111110101100101111111111111111110111111011111010111110100011111101011111a10111111100111101010110111110111111110111110111111000
1a01111011111111011111111110111011010111100110111110111101011011111111111111111111101010111110111011111111a01101111011111111111111001111011111111111111111101111
1a11101101110111111111110011111010110111110110010010111111111111011111111101111101111111111111111011111111a11111110110110110111111101110101101101111111111111001
1a11101111111111100110111111110111101111111000111111011101111111111111110111111111101110111111111111111100a01110111111111001010111111101111110110110110101111100
1a11101101110101100111111010101110111111011101010111111111111111010111001111111111111111111000111111111111a11222120001210111111101111111101011101111110011111111
1a00110111111001111100111111111111110111111111111011011011111111111111011101110111011101111011011111110111a02221110122210111111111110110011110111011011111101111
0a11011111110111111011111111111011111111111011111111100011111111011011010111000111111110011111111110111111a10220210212110111211222211020211111011101010111111111
1a11100111111110111111111111111111011111111111110011000001111101112121111212112021221222110111111111001111a12211121100211201020222122021211111111111101111111100
0a11111001111111111110010111101011111111011111100011111011110220202211111112110222112120021101111111111110a12222211112111221022112122110210111110101111111111111
0a01110110011101111111101111011111100110011111111110101111111112022121220111220111120011010111101001111011a21001122212210021102111100010111111111101001011111110
0a11111111101011111111111111110010011011000110110110101110112110112221211010212222012212021111010101110111a21111200221210111111111110111111110111111101110111111
1a01111111111111011100111011111111101110111111111111101011112200002211211112212022221112111101110111011011a22212012201211210112222121011021111101111110111111111
1a11110111101010110110111011101111111111011111111101011111112201101121021112221122200211220111101111110110a11112212201211011111101111110111111111110011111011011
0a11111111101101110111111111111111111110110011111111110111122212121210121212011122221121100011100011001111a12121220112112211112211111211121111101111111110111011
1a01011111111111110111111111001111111110111110110111111111102222221210012212201221011102211001111111100110a21022122212210111211111222111121111011011111111111111
1a11011111111111011101100111101111110111111111111111011111110102010121120111221121201200100110101111111110a10222021222112011111222012221221111110101111111111101
1a01101111111111111110110111100111110111101110101111111111000110122211121101210112202211211011111110011100a11121112212111122020112022110021111111100111111111111
1a11101011100111011110111101011111101111111111101111111111122122221221000111000012200011100100111101111111a11110210112011212221000111011201111111111101111111110
1a11100111111111111111111011010111101111001111aaaaaaaaaaaaaabababbabaabbbaaaaabbaabaaabaaaaaaaaaaaaaaaaaaaa22110211221011101000101110110111111111100111101111111
1a11110111111111111110110101111101111110111111a11111111111101122120122100120210001122211210111110011111111111110111101101110111111101100111111011111110011011110
1a11110000101011111111111101111111111011111100a11111111110110111212111110110212100212020021110110111100111122120212221111221100202122221211111111101111110111011
1a11111001111110111111110111111111110111100111a11101101111111100111011111111111110101111011101111111111101111101101001101111110011111111011100101110001111111111
1a11111101010111100111011110011111110111111010a10110111111112222112121002121112021200112121111111111100111121111122212011211222112211021210111111011011111011111
1a11111111101111101111110101111001111111100111a11101111111111211220210012121001111011110111111011010001111111111011011101011111001111010011111010011111111110111
1a11011111100111110110111101111110111101111111a11001100111011011111111011111111111111100111111111101111111111111111111111000111111100111110010111011110011111111
1a01111111110111111011011111110111101010101111a11001111010011100220120122202111120212201221011111111110011122101110220001101110212112120010101011101111111111111
1a11111111110111101111101101111111111111011111a11101111111120212121211222202112011201101011111111111111011111110111111111111010001111111101111011011010111011001
1a01011110111111111111111100110111111110101101a11111110011112100011121200200112111101221121011111111111010020022022101111011111111111110111111111111111111111111
1a11001111111111011011000111101111111111111111a00111101011121202111202200111122000201121210011110011111011102022120112212221022121021121011111111001011010011111
1a11001111101011111110011111111011101110111111a11111000111101110222021212021012121211121011111001010111111011011111011111110111111101111111110100101101111101100
1a11111111111110101001111111101111111011110111a10011111000112012211001201221221122112112221011101001101111021100112211211100122210221111121011111111111111101101
1a11110110111110111110101111101111011111001110a11101011001120112120211021120101112222021120011110111111011111221212222110011011122111201221110111111101110111111
0a11111111101111111101111101111111111111100110a11011111111121112122211212212011112121202201011010110101101100212110121210220221122012220220011111000101111011011
1a11110110101111011111111111010111111111011111a01011111010122220221221211012010110220222211111110101110111112202201120212112222212021211021111111111111110111111
1a11111001110101111011111000111111110111111111a11101111011122112021111112212201101101112211111011011110011122122111022110222121121222121012121111010010111110111
1a11110111111111111111011101111001111111111011a11111110111121212110012101000111121211210101110101111101001111122211212111221122111111221021121111111011111101011
1a11111111111110101111111111111110111111111101a10111111110101220111211121020202021212110101011111111111111111121112120110201111112121021221011111011011110111011
0a11111111011001111111111111111111101111111101a11111011110021210111222200121121102101111120110111111111111100112110122110210022012022101102121011111111111111111
1a11110111111111001111111110111101110010110111a11110100110111111111111111111011111111111011010101111111111111101102120110220222111111121111121111011111111111110
1aaaaaaaaaaaaaaaaaaaaa011111111101111100111110a11010111110111111101011111110011111110111111110111001111110111120122022212202110221101101221110111110111111110111
111000110110011101111a100111111111111100100101a01111111111011011111101111111000aaaaaaaaaaaaaaaaaaaaaaaaaaaaaaabaaabaaabbaaabbaaaaabbabbabaabaaaaaaaaaaaaaaaaaaaa
101111111111111011111a101101111111110000111111a11101010011111101111111110101010a11111111111101111110101111101101111011111111110101111111111111011101111111111111
101001011101111111111a011100011111111001011111a11110111111111110110101101111101a10111110111111111111111101111012101222112102202122122210211121101111111111110111
110111111011111010111a111111111010111111111011a11011110111111101111111111111111a11111111110111111010111111111100120212110012111112122021112001011111111111111111
110111111011111011111a101111111111111111110111a10111111111111111111101111110111a11111101111111101111101111111111110110111111111111111101011111110111111101111111
111101110110111111110a011111011101111111111011a11100111101101111101110011110011b01101111101110100100110001111111011011111011111111101110111110111111011111111001
111100011111110111101a110011111010111111010111a10111111111111011001110111011110b11111110101111101111101111110111111101111111111101011110110111100011011011111101
110101111111110111110a111111111100111110111111a11110101101111111111111100110111a11111101100011111001101011111100111111111110011101011011111011001111111101101111
110100111111111111000a101111111101110111111111a10111010011101111011011111111111a01111121221220111121121121221122100221102112211221110121021101011111111111111111
110100111011110111101a111111111011110101110111a11111111011011101101101111111111b20121111110211120111111221211102221201110111112020222112211121111110101111011101
110111100101111111111a111110101011110111110111a01111111110101111011111101110111b00110111101110111011101101111111111010101101110111111101011111111001011111011111
110111101111111110011a111101111111110001111111a01111111111111101111011111111111a12200212211120101221122212212002210200112220221112102221001111111111010101111101
111111111011111111011a111101100111101101111111a11011101111110001111101111101011b11111111111111111111001101110110111111111111101011110011111001111011011111111110
111111010111110011101a011111100011001111111011a11111110111111011011101111111110b12021210101222100020222102212201222200110221211120111101112101111101101111111111
011111111101010100110a101101011111111111111111a10110111101110101111110111111111b22101212221211122201112201210102210211110011212201022122122111010110111011101011
111101111110111111111a111111110111001111111111a11011111110101001111111011111101b21002101211112221200022111222121111212012222222112112021112111111111001111111101
111100111111111111111a011110111111111100101111a11011110111100111111111001110011b12212101222212011111001110111111111111111010111111111111111111111011111101111110
111111111111011111101a111010010111011111001111a01111111111100111101111101101111b22021111212201220101011121221110212011100022212120011221111111011111110111111111
111111111111011011111a100011110111111001011111a01111111111111011111111111010110a01211122112212021110221121121101111121011022211121022122222010011111110111011111
1aaaaaaaaaaaaaaaaaaaaa101111111110101111011111a11111010111111111011111001101001b12111210222111211111212121112121120012211012210211122110012121111111101111010111
1a11111111100111100111101111111111110111111101a011111111100aaaaaaaaaaaaaaaaaaaab12121121221001111101112001101211110111110111111111111110110111111111011111111110
1a11010011111111101111101111111111011111100101a111011100111a1101111111110111101111011111110111111111111110111111111111110111110001111100110111011110001111101111
1a11011010110111011111011101111111111111110111a101111111111a1111011111111111110012112010121122100101222110101121011111111111111001111111111111101001111111111111
0a01101111100110111110111111111011111111111111a110111111110a1111111110111111111112022201102122222121122211212001101101110111111110011111111110111011111111111111
1a11010011111111110111101110111111100011011111a111010111111a1010101101111111110012222122112111021211121011002221111110110101111110111111111111011111110111111111
1a11111101111101110111010001110100111110111111a101111110011a1110111111110111111121100211122102112111110022011211111111011011110111111111111001111011111111111001
1a11010110111111111011111011111101101110110101a011110111011a1111011111111111111122001200121022101011201221222221101101111011100101100001110111100111111110101111
1a10111110110110110111111111111011111010111011a111100111111a0111111111011111111102111111021122201211212220211211111110111110111111111101111001111111101111111111
0a11111101101010111011011111111110111011011001a111101011110a1110110110111110111111010121001111212120111110111110111111101010111110111101110001111110110110011101
1a10011001110111111101110111111110110111111110a111111111011a0111111000011111111022221212221122211121121111111111111111111011111110110011111110111111111011110110
1a11111101111011111011011011110100010110111111a111111111111a1111111111111110101112021222222021111211002011022021110011110001111111111100101011111111111001011111
1a11111111111110110110101110001011111111101010a111111111011a1101111111011111110112212021001201222221111111101111111101110111011110110111111111111111111111111101
0a11111011011101111101110100011111111111011011a111111111101a1110011011110111010110012222222201112211111201212121100001111101011111110111110101101011001111111110
1a11111111111110101111111111011101111111111111a111111111111a1011101111111011110110011111111111111011100101110110111110011111010011111111111111100111111100110111
1a11111101111111111111110111011111101111111001a011111111111a1111111111111011101001110111111100111110111010101111111111011101111111101111010010111111111101111011
1a11111011111111101100111100110111101011011111a111011111111a1011011011011110101010211002021122100121221122220121111111110111111001111101111010111011111111111111
1a11110111111111111111111111101110111101111111a010111111011a10110110001111100010221111012212112111111221122111211101111aaaaaaaaaaaaaaaaaaaaaaaaaaaaaaaaaaaaaaaab
1a01001110111111111111011111011101111111111011a111011111110a11111111011110111111111111110101111001010111101111101111101a0110111111101110111111011011111010011111
1a10111101010101111111111111111111110111011110a101110111111a01101111111111111111200211211021212222112102221222211111111a1111101111111110111011010111111101111011
1a11111001101111111110111101011110100110101111a101011101111a11111011111101111000110111111110000110011111011101011101111a1111111101111110111111101111110101111011
1a11111110111011110111111111111011111011111101a001111110111aaaaaaaaaaaaaaaaaaaaa101122021111002010111111021022011110111a1111101110111111101110111111111111110011
1a11111011111111011111111001111111011111111101a11011111101111001010101111110111a022201101122221212101102222111011111011a0111111000111111101111111111110011110111
1a01101111111111111111110010111101111011100011a01001010111110110100111110111101a212221010120100122211011110111111111011a1000111111111000111100000111111111101111
0a10110111111101110111111111111011101110111111a11110101110101011111111001111111a111111011011101010111111111011111011101a1111001101011010110001111011110111101111
1a11100111111111111110011000101111110111111111a11111111110111210222012201011101a222212221011010100212102102122111101111a1111111111111101111111111111111011111111
0a11010011011110111110111001111111011011111111a10111111101110122221022222110221a222121112211122121211201222201211011011a0111111110111111111010111111111111011111
1a11111111011111111101100111111110011010111110a01111111111111112122112122012212a110211112221122212211121210221111122121a0012211101110101111011111100111011111111
1a11101111101101111111110111001111110001111111a01110111011111112202012122222111a020022112122110221201211022210120221111a1211210111111011010111111101101111111101
1a00110101011111101111111111001110011011011111a01110011111111201222220202011212a022221202111222122111110102122020101122a2111100011111001111111011111011011111112
1a11011011111011110011111111110011100110111110a10111111111111221120220112202221b122211211222011212210122122222221111112a1122111111000110111111110110011101101101
1a11111111011111101111011111111010011101111111a11111011111111210220222221201011b212212112220011122202112211121112212220a1101011111101111111101111011111011111001
1a10110111111101111111110111110111111110111011a10111111111111002012021111112221a212001212221102221210121110221121212121a0110210001101011101111111111100111111111
1a11110100111000111111111101111011110101111111a11111111011111221012021211022012a110020011210202120101111111000111111011a1111111001111111110110111111111111101111
0a11111111011001101111111101111111111110111111a11111111011111200111221122022210a111011011111010111110111111011110110111a1111111111111101111101111111100111011011
1a11111111111101011111110111011010111111111111a11110111101010101210122221000001b112002211201002021111221221211011022012a1122211111100110011111111111011011111111
1a00111111111111101111011111101111111110111111a11101111111111112012121110111222a012222221120111222112112102222112121122a1102211111111101011111111111110111011110
1a11111110111011111111111111111111111111001101a11110011110111022210202021222102a220202001212111221112221120022111020222aabbabaaaaaaaaaaaaaaaaaaaaaaaaaaaaaaaaaab
1a11110011111111111111011111111111011001111111a11111110111101120121011110221110a12012221110201222111110112112110220122211111101001110111101011111111111011011101
0a11111110111110111111101111011101000011111110a11111111111110022221112211221202a10211212122211211221002221011112112122211212211111111111111011111111111101111011
1a11111101101111111101111100111111111111111111a10100111111111001222122210121211a22012102212211210000110111110001110111111111011111111111111110011110111101101111
1a11111101111011110111110011101101101111110101a11101110111111212121111201222220abbbbabaabbbaaabbaababbbbbaababaabbbaaaaaabaabaaaaaaaaaaaaaaaaaaaaaaaaaaaaaaaaaaa
1a11111111100110111111110010111100111111011111a11110111011111102201112101000211111110111111111011011110101111011111110111101011111110111111111111111111110011011
1a10111111101110011011111111011111000111111110a11111111110111020012021211121202222100011120110211110021212211201210001112111211111101001111111010101111101111010
1a10011011111011110111111001101111111111111111a10110111111111101111101111010111111111111111111111111101111101111111111111101110101111111100100111111011111111100
1a11111111111111111001011111011011010101100101a11011111111101221211122002221022222212001120111112221021020200201012111111200211111111111111110111111111111111000
1a11111111110111111111011111111110111111111111a11111101111111110122122111122101121211102201101221111111111111110111110011010111111011011101111111101111101011111
1a11101111011111111111110101101000111111111111a11111111111111222110111122101222002211110110111121101202211101111212211210222210111011111111111111110101100111111
1a11111111111111111101111111111100011111101111a01111111111111120222222212122211212020112111010222111111111111111111111111111001111011111111111111111111111001111
1a11010111111111111111110011111011111101100110a10011101111111211101021211200020100000121210211112212012021121210121121102212201111111011111101110111101111110010
1a11111011101110111111101111111111111101101111a11111100111111121222122101211112212111220202211212021110111111111111001111100011111011111111111111111100101111101
1a10110111111111111101011111111110000100001111a01011111011111011210111020112121210212211111010222111201112022021211221112122211111011111111111111011111100111111
1a11111111111111101010101111101111111111111101a11011001101111220122211102222111211012121111111211201111120210221222220112002101111011011111110101111111111111111
1a10101011111111111111110110011101111111111011a11111100111111112221100001121121111111221221111112221112200122212111101011111111111111101111111111111011111011101
1a11110111110101111110001111111111111111101011a11111111111011111121111012122121012012011221210122110122120120121122011110222111111111101101011010111111010101110
1a00111110011011011111110011111111111111110011a11110100111110111110110111011101110101110111111111101110111010111111111111111101111110111110010011111011111001111
1a11111111110011111111110001111111111101111111a11111111101001111101111101111000010011111011011101110110111111101111111111111110101011101111111111111111111111011
1a01110011111111110111111101111110101111111111a10111110011111101111101111101111111111111010110112121111212020202211011101101111010110110011111011111101101101111
0a10011111110100111111111111111111111111111101a01111111110111111101111110111111111110101111010111100001110111111101111110111100001111111111011111110111000111111
1a11111111111111111111110111111111111101111110a11101111111111101111110111011111011011110111111001111011111110110001011011111111110111111111011111110111111110101
