114 157
28 150
114 59
117 45
56 60
4 132
42 125
47 67
19 104
10 88
1011111100111111111111111111111011101111111a101111001011111111a11010111111111111011111010001111010111111101101101101111111a0110111111110110011111111111111111100
1110100110111111110101110111110111111101111a111111101110111111a11111111111111100101111011111111111111111101111101111111111a1111110101101011111111110111111111111
1100111110111110100111011111111110111001111a100011111001001110a11111111111101011111111011111110011111111111101111110011111a0111111111011110111011111111110111101
1111011111011110111011011110110111111111001a111111110011111011a10111101001111111110111111111111111110110111011111101111111a1110110011111111101101111111111111011
0011111110111111111111111111111111110111111a110111111111111111a11111111111011110111110101111111111110111111110011101111111a1101111012211211111012101211211221221
1000101010111111100101101111111111111011111a111111111011111101a11101101111111101001111110111111111101100101111111111110111a0101111110112011211000211021102112210
1101110111110011111111111111111111100111111a011100110111110111a11111111111111111101111111111111100011111111111111110000111a0111111012110121011212100221021221101
0101101101110110111111101011101101111111111a111111011010111110a11111111111110111111110111111111111111111101010111111111100a1111011102221222011221122210121111112
1001111110111110111110111111001011011100110a111110111011111011a11101111111110111110101101101111101101100111111110111011101a1011111101010211112220101200222222210
1111111110110110001111111101101011110111111a111011011111100100a10101111111111111110111110110011110111111101111111101111011a1111111111122212222002222222212211101
1101111101011111101101111111010011101101111a111110010101111010a11110111111111011111111110102212220120022121111120012111110a0101111100110011122201021112101122221
1111001111110111101111011111111111111111111a111111111101011111a00111001111110111111111112110221211111220121122211102201110a1111111112211202011222012111121212122
1001101111101111101111000111111111111101101a111010111011111111a11111001111010101111011112122111200122211102222121022201111a1111110112221111022212122102200202212
0101011101111011011001111111111111101111111a011111110011100111a11111111101111111111101111122112021120212112110121112121111a1111111111211212222110011121102012110
1110111111111110100101111011011011011000111a111100110101110111a11111111110110110011101111222101112102112111122211021011101a0111001111022112022101111220120112211
1111111110110111100001101111111111111111111a111101111110111101a11111011110111111011010111201211222111102122122210120101101a0111111010222201110111000121210112121
0111110111111101110111111111011111111110011a111110111111110010a11110111111011111111111112120011012102221122121211001001111a0111101110221211211020221222112112202
1101111110110111101101011111111111011110111a111101101000111111a01101001111111110011111012202221110021212011111111211100111a0101011111212221110201012212221222221
1111011011111111101101111111111011100111110a111100011111111001a11100010111110001010111001121212122102111121011201020021111a0111111102211222112221210222120222020
0111011111111111111111111000111101011110101a111101111111111111a11111111111100111011110111212111110111212122120222020210022a2121011221211211200200210011222110222
1100111101011111111111111111110111111110111a111111111111111011aaaaaaaaaaaaaaaaaaaaaaaaaaaaaaaaaaaaaaaaaaaaaaaaaaaaaaaaaaaaa1110102212220022222122222220211112212
0110011011111111111111111111011100111101110a10011111111111000110111111111111111001111101121212202111222122021222101122001222121011021122202210121222211021221212
1011111101111111111010111011111111111111011a11111111111110111111110011111110001101111111002111022221102110122112022111102221200211000200112021222221011220122121
1110111111101111111111111101011111101111111a11110101111101101111111111011111110101110111211221121222102121122112211012101201221212221221011121012111221221212022
1011111111111111110111111111111111101111111a11111101110010111110101011100110111110111111101212221201121112221220121222212212021221111011111121001022211110010110
1111111111011111101111110111111101111111110a11110011111111100111111111111010111111110111121012012102122122222012110110221202211211111211010221202010222211211210
1011111111111111111101110111110111111111011a11111111111111111111111111110111111100111111220121200011202021021200122122112101122211212022010122202011210222121222
1111111110011111111011111110000100110111110a11111001110111111101111111101001101111101111202102221121121100222021211121011121022222222102201201011020000120112121
1111101100111110111110010011101111111110111a01010111011010111100111111111111111111111111121220222121222112212100111201012122012220212120222111111122112211212002
1111100111111111011011110111111111111111110a01111110001011111011110111101111111001111111111202221110212121101121221222212212211222212011010121120211220120021101
0111110111101110111101011111111111111111111a10011111011111101110111110111011111111111101110111201212122011211201222212111201211110220102110211222202211111010020
1111111011111101110110111101110111111111111a11110111111011111011111011110101111101011111120222122101212121221112202001000121211121202222211021222122101222121121
0111010111011111101001111111011110011001110a11111111111111101101011110111111111111111111012220221110202121222102102211121012022111201122222101122020221021112212
1111110111110111111001111111111011111111111a01111111111110111101101110111111111110111101111201210112212122110111110010120020201211020201201102222221100212012211
1111011111110100011011110111110011111101111a11111111111111110110011111111101110100111111112122212122021122120201211122122101121112120222022100111121121121010222
1111111101101111111111110011111111110111111a11101011011111101110110001111110111111111111120212012211111022212110122112111111021111220221111111111101101110110011
0111100101011111110111110111010101001111110a01110111111111110011111110101111111111111111001201011200220011021112022010202222122122121221111111100101111011111111
1111111111110011011111111101111111101101101a01111111111011101111111111111110111110111110201122011202121102222121210212112121112002111101110111101101111111111111
0011101111111101110011111111110100110110101a11111001011111111111111111101111010101110111201211211220212120120212112212002021121011102020110110111100111111111001
111aaaaaaaaaaaaaaaaaaaaaaaaaaaaaaaaaaaaaaaaa01111011111111010111111111110111011111101111210011011020212122110211011022121112111111111111101111110101111111111111
111a110100101111110101001011111111111011111111010111101111000110111010111111111111011011111111111111100102111121111101200202122111212211111111110111111110111101
111a001011111111110111111011111111110100111101110100111111111110101100001101011011111011011000011110111102221110121010200121221011120211111110111100010111011111
111a101111111111111101111111111111110011011101111111111111111011101001111111111111111101111111101101101120211122211112111122201221202201221211112220102100111111
111a011011111111111111011101111110011101111111110111110111111101110111011010111111111111011011101110111111221101120011011212121011211102120222220202222222220111
011a101011111111100101111111111111111111101111111111111111101111111111111111001010111011011101111110111111111012111010102011022212221121201111112121101221111111
100a111111111111100111111111111011111100111111111111011111111111111111011111111101111101011111111011111010022020220110222221110201012011222211202120111120200011
110a111111111110101011101111111110111001111111001111111011011111011111111111111100110101110111011010101022222222120112122111100121121211210222212112222112211111
111a011111111111011111101011111111111111111111110101111111000001111102111121112121102200211212112211111120222111121121122000210020012121222111111011210222110111
111a111110111101110011111101011101111110111101111101010111111111101121100121010211100112210222101201111122222212002220212221212100110212022112212111121021221111
111a111011111111111111011001111111111100011111111111100111110100111122011002121112211222101211101211111110101111202121201212221112221002022112022112101102111111
111a111111111111111111111110111011111111111011110011111111111101111110101212212210001020221222110210101110110111101111111011121021111011000212212022112202120111
010a011111011111111111010011101111001111111111111011111111111111111010120011102022222122211212111201011011101110110111111111111100101201101112010122121200011011
011a111111101101111011111111111111111101110111110101111011111100011120101221111121211002202200011211111100111111111011101110012111112112022011012021202211201111
011a111101111111101111111010011011101001111011110111111110111001111020111212102120102211121112111111111010111111111011111110112100200022011112122111021211111011
111a110111111110100010111101111111111110010100111111111111111111111112101222012012222120211211201210101111111111101111111110112121212112012111222211002112211101
011a111111101011011011111111011011111011111100001111111011111111111111112121010021222200201211110211111100111010111011111101122022111121112001221221211221201111
111a111111110010111001111111111111110111111111111101111111111111011011111122021121111111121101210010111111010111101111111111100211221221211211022011022220121111
101a111111111110111101111111011111111011011011001110111111010122021121122221220222112220112122110201111111010011111111111101122111201012012102100202110212111110
111a001011011111011111111111111111001110110111011111101011111012121112100212210111220102120211002210101111110111111011100111102101212222111222020101121220111001
001a01111110111110111111110011aaaaaaaaaaaaaaaaaaaaaaaaaaaaaabaabbbabbab11210210211021122211111012211110101101111111110011011121121211220112012111110210121011111
111a11111111111100111111111111a011111110111111111110101111010111011112b11011101111111110111110110111111111111101111100111111122201001112222111022121122222011101
101a11011110111111111110001111a111111101111111111110100111101012001121b11122212111121212201220011011101111011111011111110101122011221222011100201102111201121000
111a10111111101111111111110111a111111011101011111111100110111122221022b10210120221112220120212110111100111011110110111111011122211202111102201011011121212101110
110a11111100111011111110011111a110100111110111101101111111112011221001a11201021001111202111221212011101111001011011010101101121211122212212121221100202220111111
111a11011111111111100011101011a001111111110111001110111111111122121121a12112002220201111121120011201110111101011111111111101011112120220221110220112121102021011
111a10011111111111111010010100a111111111111101111111111111000121211201a02121122121221122122012201211011111110111001101111011122212220220100221222111012110120011
111a11110111011101111101111110a111110110111111111111100011112210220111b00222211202112211222122110110111101111111101111111011110011021220221022101211101101221111
111a11011111111111111111111110a111111011110101111110111111111112021222b10122112110210212121220211110111011011110110111110111011221011101122121211122112122111101
101a11101111101010111111111111a110011100111111110110011111110022122221a22002212001122121222211201101111100111111110111111101122202022121220102102021211121011110
011a11111111111110110111111111a011111011111111110011110011100211002011a01202010211000101220211200011111100111111111111110111122210111212212221121121011210211101
101a11111011100011111101111111a111111101110111111110111011101110022021a11222111121122211121022211111110111111011111011111111122121201120121112210211122211211111
110a11111101111111110110111111a111111011111100101111011011101202211222a11222111121110122122011211200110111111101111111101111110111211212211212121021011222111111
111a11011111110110101111111111a101011110001011111111101100110222111112b11210121212001122121111111111110101101111011110111111001121111110211222201221221221111111
101a11000111110101111111011011a111111100110111011101011110012120120210a21002221222120222000122212001111110110001011111111110111011111111111111111110111101110111
110a01111111101011111111110111a011011011110111100111111001111210022221a10101211222101111122221111001111111010111111011111111111110101101011111100011110111111111
111a01010111111110111110110111a010111111111110100010111111111022222002b21210010122112012212222102111111111010011111111110111011011111110111111101111101101001100
110a01111101111111011110111110a111100111111110111011111111111000010220a21011221221222011111112101211111111011111101111111111111111111111111111101011011011101011
111a11100100001110111110110011a110111111111111100101111110110112222220b11022000211221120021122212211111101111001111101111111101110111111111111111111111111111011
110a11111011101111011111111111a111101111111110111111111111112201212122b02220112120222201112011111011011101111111111101011111110111111111111111110111110101110101
101a11110111111111111101111011a111101010011101111111111111111100111111a11122012201212221112011110111110111010110111111101100100110aaaaaaaaaaaaaaaaaaaaaaaaaaaaaa
111a11011111001101111011100101a011101111111111111111011111111110200212a01111111101101111100101111011111110111111011111111111101110a01111111111011101011111111101
110a11011011111110111111111011a111111111111111111101110011112002011112a11122112102110200201110111111110111111110111111011111101111a01111011011011110111111100111
111a11110110010001101111110111a111111111111011111111110101011121220020a20122220221201110102111111111111111111110111111111101110011a10111111111111101111111010111
111a11111111111111111011000111a010100011111111111111001111011112222111b12112120211111221120111111101110101101100110101111111111111a11111010111111111111111111000
011a11110011111111011111010101a010011111111101100111111111112112022112b20111211221212112111111100111111111110111111111111111111111a00111111110111111111111011111
001a11111111111111111111111101a011001111111011111101111111112110200102b11012221210122100000111111011101111110001111010011011101110a11011111111111011111110101010
011a11101111011110010111110011a111111000111101111111110110111012111112a21110012202101121121011101110101110011111111101111111111111a01111101111000111111111111011
111a10110111111111101111111110a111011001110111011010000111011011011111a11111011111110101111111111111110100100111101110110111111101a11111100011001111111111111110
111a11111111011101101101111011a111011111110111111111111011101011111111a11111101010111111111011011111111010111111110101110111111011a01011101111111110011111111111
111a11011111111111110111101101a110111111111111001011101011111110101100a11111110101011111110011111111011110111111011111011111110111a10011111101111111101101011011
111a11111011101110111111111111a111111110110101111101110110101010111111a11010111111111111111001011111111101111111100110111111111110a11111111101110111111011111110
111a10011111101111110111111111a111010111111110100110101101111010111110a11110111101110011111010101001010110111111110110111110101111a11111001111111001111111011111
111a01100110011110101110100101a110111001111110101111100111011011111111a10100001001111111011101111110111111111110010011111111111101a10101011110111011111111111011
110a11110001111111111111111111a111111111111101111111111111110111011111a01110111110011011111010110111101001111111111011110111111011a11110001111111001111111111111
111a11111111111101101111110111a110111111011010111110011111011110111110a11101101111110111100110110110001011111110111011111111100111a11010111111111111111111110110
111a11011011101111111110111101a111101011101101110111111001101110111000a11101111111110111111111111011111111111110111110101111111110a11111111100011111111011101111
010a11011111110110101111101111a101011110111101111011101111111111111011a11011101110111011111101001101111111101111111111101111111111a11111101111011111110111111111
111a10111010111010111111111011a111111111111011101101101110111010111111a11111110100111011110111110111101111111101111111111111111110a11101111110111111101111111111
111a00111111111111111111101111a111111110101111111111111110100111111111a11111100011111111011101111111011110011110111111110111111111a11111011111111110101111011101
011a111111aaaaaaaaaaaaaaaaaaaaa001111111111101011110101111111011101100aaaaaaaaaaaaaaaaaaaaaaaaaaaaaaaaaaaaaaaaaaaaaaaaaaaaaaaaaaaaa11010111111111111011110111111
101a101011a11110111101110111110101111110101011111111111111111111111001111010011111011111011110001001111111111111111111111011111011001101111111111100111110110111
111a010111a11111110011111011111111111011111111111111111111111111111111111100111001100111111100111111101111111111010111111111111111101111110111110111110000001101
011a001011a01001111010011101101011111111111111111111111101010111010111011111111111111111111011111101111110111010111110011111111110111110111011110111110111111111
011a111111a10110111111011111101111111111111101111110011111011110111111011101111111101111111111110111111111111001101111011010001101111111011111111111110101101101
111a110011a11111111101111111111111110110111111111111111111111111110111111111111111111111110111111111111011101111011111001111011101111111110111110111011110011101
101a111011a10111111011010101111101110111101011111101111011101110110011101011111111111101111111111111110010111101111101111111111001111111111100111111111111101111
001a110110a01110111111101111011011111011111111011110101101111110111111111010111100111111111111111111110111011101111101111011110100101111111011111101001101111111
111a110101a10110010111111111101101100111101111111111011110111111111101101011101010111101111111110111101110011111111111011110111111111101111111101011101101111001
110a101011a11001111101110110110111111011111110011101111110111111111101111111111111100101111111100111111111100011111110110001111110111111101111110011110110011111
101a111111a11111111111101111111111111101011111111111110110101111111101111111111000111111111011111110001111111110111111111001111111101011111011111111011111111110
100a111111a01111110101111111111111111110111111111011101111111111111011111111011111101111111111111110111111111111111101111111111110111110011101110111111110111111
001a111110a11111101011111111011001111011110111110101110110111011110101101110100111111011011101111101111111111111111110101110110111111110011111110111111110111111
111a100111a11001111111101101101110101111111101111111111101011110111111111011111001111101101111111011111011111111011010110011111100111100111011111110110010111001
011a001111a11111111aaaaaaaaaaaaaaaaaaaaaaaaaaaaaaaaaaaaaaaaaaaaaaaaaaaaaaaaaaaaaaaaaaaaaaaaaaaaaaaaaaaaaaaaaaaaaaaaaaaaaaaaaaaaaaaaaaaaaaaaaaaaaaaaaaaaaaaaaaaaa
111a111111a11011011a11111101111110111101110111011111111110022101211211221022102220112121111111111111101111111101001101100111111111011111111111110111001110111100
111a101111a11101110a11111011101111110111101111111010110111112121201211012220222021112100211111010111111111101011100011110111111101111101101101011111011110111011
111a011011a11111101a11100110001111101011111111011110011110120121211112221201012111112021110111111101111011111111111001110101011001010011010111111111011011011111
111a111111a11011101a01111111010110111001011111021102101221111100211111222102211221111020110101111110111011111011111011110111111111100111111101101100111111111111
110a011111a11111111a11111111111101111111111112121211000121121020121212222220211211012221001111011111111101101011111101011101111111111111111101111111111111111110
110a111011a11111111a10110111101011110111111112211121110121211101221111011211222122002121211100011001011011011111110111111110011011111111111111101111001011111111
