119 73
60 1
59 66
72 133
84 112
16 154
111 11
11 75
67 63
22 124
11111110011011111111111111111111100111111111111111111101110111110111110111111101a000a101110011111110111110110111111111111111111010101111101111111111111101011111
10001111011111111110000111111111101101111111111110111111111111111110111111111111a101a111111111111111111101111111111111011110110110111011011111111101111011111111
11111110111110111111111011111111110111111011011111111111110111110101111011011110a110a011101111111111111111111101111111010110110111111110111011101111100111011111
01111111111010111111111111110111110111111111111111111110011111101111011011011111a110a111111100111101111111111101011110100111111111010110111100110110110111101110
01100010111011011110111101111011101111111111111101111111110111111110110101111101a111a111111111101100010011111110010111111101111111011110111011111101111111111100
11110101101001011111111101110111011111111011111111000111101101011111111101101111a010a111101111110111011011110111101111011101111111110101110111110111111111111111
01011010011111111111111001111111011110010110001101111111111111111111001111111011a111a111111101001111111111111111111111111011111111111100011111111100111110010111
11101111111111111111111111111111010111111010011110110111111101101101111111100101a011a110111011111111010101011110110111111111011111111001111111010111111111110011
01111110111101100111110111011011111110011111111011111110111111111111111111111111a111a111111101111011111101101111111111111111111111001111111111111111110100001111
11111101111111110111011111111111100101111010111110111110111010111111101011011111a111a010111111111000111111110110110001100111111111111111011101111101011111100111
11101111001111010111111111111111110110110101111111111110001010110011111111111111a111a111111011110111010110111111110111111011111101011111110010111111101010101111
10110111101011111111111101001101111111001111111101011111011001111010111111111122a122a012020211211212112011010111111010101111111111110110010111010111111111111111
10101111111100111111111111110111011111101111101011111110010010011111110010122200b121b120121222100121101112110111111111111110110111110100111001011001011101100111
01111011101111111110111011111111011011111111011111110001011111110111101111022001b211a210202102212021221121111111111111011111111111011011101110111011111100111111
11111110111111101011101111101101111111111011100110110111101111110111110111112112a022a102122112221111112022111100111101111010001101111111011101101111111111111111
11110110111111111111111111111111111101111110111111111111011111111110110111111212b210a112220222211111222222011111100101111111111111110111111111111111111101011110
11011100111111111101110011101111011111111111101101011111111101110111011111011222a220a012202021020211211111111111010011111101101111001111101111111011111110212210
11110111111010111110110111111110111111111111101111111111111110010110111011111121b020b212001122222220221102111110110111111111011111101111011101111111011111210100
11111011100101100111110111111111110111011111111101111111110101100111111110120112a222b120121102220011221210111011001101110111110110111111011101010111111110001222
11101101111011011111011111111001111111111111111111111110101110111111111110002021b121b221012211221121122010111111111111111011101011101010110110111111011111021212
01111101011000111111111111111111110001101111011111111011011011011011111111122121b001a120122112122102220102111111110011111011111111111111110011110101111111110012
01011111010111111110110101111111111010110100111111101111101111110111101011102211b212b222212222121222220221111011100101010111111011111110111111110110001110112111
01111100100011111111111111111011101010111111011111101100111111110111111111122221b112a112111122210101122110111111111101110011021221001221002121112210121001212211
10011111101011111111111111111111111111101111110111111111111111111111111111012111a110b022112122111110110021111111101111111110210112020222112201211112122021110121
11101111001101111011111111111100111011111110111011111111110111111101100111121112b211a211121211221101220221111011111110111000011102121211110021212211121122212120
aaaaaaaaaaaaaaaaaaaaaaaaaaaaaaaaaaaaaaaaaaaaaaaaaaaaaaaaaaaaaaaaaaaaaaaaaaababbbb011a202122221210201101212111111111010001111211211121110112120220112010011111110
011101111011111101111101100111101011101111000111111111101111101111011110111102122102a221221220221221111012111111001110111001120211021211212211021211121210101001
111011110111111110111111010111111110111111101011110111111111011011111110111221112120b222222020121012101111111011101110111111001001112122112011221101122212111111
111111101101010111110111111111111110110111111111011010111110101101011111110110211201a111021210212202102022110101111111111001022220202221212011112121112211221212
011111101111011001111111111001110111110110011101110110111101111110111110111221210222a211021002101212220021111111111111111110210201112211102111202212012220002021
110001111111111111110111111111111111111011111111010111111011011100111110000202112110b210221010110211212120111111010111100101221021010112202211120121100022210212
111110110111111101011111111111111110111011111111101001111111011110011111111202120222a112202221201100120222111111101110101101120121102221111120111121210222102212
001111001111111111011101110111011011111111111001101111011010111111110111110122011102b221202111121202012221111111011111111111122102111102221111121111021111212002
011111111111110101111110111111111111010011001111011010111111111111110111111102122202a122212221001112212221011111110101111111201122010222021112021011212212222210
110110010110111111111111111111111101100111110111111111111110111101101100111022221211b222021011102121110202111001101110101101121201221100220122001002211111211112
111111011111111111011011111111111100101111111111110011101111111111011110101201222000b000111202201120211212111011111101111101021112222012210211212112121001111121
100111111111111111111101001111111101111111111111111111111001111011100111111221211112b220222210011111201202111101111111001101101022012011010201022212221212221002
101111010111111111101101111110111111011111111111011111111111111110100110111222211101b211110222012111122112111110100111111011222211211212222221022011111210210211
111101010111111111110100111111111111110111111100111101011111101011101111101101110211b212120221201212211111101111011111111101011112111122011211010000211101222212
111101111101100110111011011101111111111111011111111111111011111110111111011201211202a110212210121112221110111111000111101011220212012220222212220210002211211211
111111111101111111111111110101101111101111011111110111011010110111101010111111221121b122102021110221122012101011111101101111101022112111222022111121122121112120
111101111111100101111101111111111100110011100111000111110111011011011101001202112211a001212112120201011112111001101010111111220211120210111101011011212221012022
011111111111111111011111101100111111110111111111101011111111111100000100111111111111a011111011111111001101111111111111001111101221122221111010210112222110121122
111111111111111111111101111011111111110111111111111110100111111010011111101111111111a011011111111111111011110111111111001011122001201222202122121112210111220012
111101111110101001111111101101111111111111111111111110110111111111011111011110110111a100110111110110110011011111111101111101022211212012012122222212221201220122
110111111111111111011111011111010101110110111111111111111111011110010110111111111011a110111111111110111111101110100111111111212121112222221121220111011221111200
111111111111101111111011111111111111011111111111101111111111010110111001111111111101a111110101111111111111111111111111101111020120122221220211211022212011112121
111011111101111111110011001011101111111110111111111101101111101111111111011010110111a111111001111110111011111111111110111110121120110212201121220202212121111100
011111010111110111011101111111010111110110001110111111010111110011111011111011111011a111111110110111111101111111110111111101110021112121001112220112222111210111
110111011101110101111111011111111111111110001101110110011110111110101111111101111101a111101100111111111111111110111111111101111210222110110112001121100212011111
111111111101110111011111111111111111110101000111111111111111101010011101011111110111a111111111111010100110010011111111110110021022012012022210222011121010111111
110101111101111111111111111111101111001111110111111011111110111111111111111111111010a011111111001101110111111111101111101111101212220211220110212121211222111011
111111111110111111101111111011111111111111100111111010110111111110111111110011111110a101111111111111111111111111110111110011211012102212111022210110010101011110
111101111111111101111011111110111111111101101010111111111011111111111011111101101101a111011011111111111111111101111100111011111011110010111111111100110011011111
111101111110101101111010010111111010111111011111110111110111101011111110111111111111a111110101101111101011111011110011101111011101111111001110111110111111111110
111111110111111101111111011111010111111111111111110111110111110110111011110111111101a111111010111101111101101111101101101111111111011111101110110110110011110111
111111010110110010111111111001111111111101111011111111111111111111111111010111101110a010101001111001111000110011111111111001111011110101101111111110101111111111
111111011111011111011111111111111111100111110101111111111110111111111111111110100111a111110111111001111111111101101011111111110111111010111111110111111111111001
101011011011111111101011111110101111010111111111110111101110111111011011011111011110a111111111111111111111111111111101101111101101111111011110111101101111111111
011111001111111111111110111011011110110100001111011110100101111001210201111010212221b122211012002111110111011011000111111111111111111011111011111110101111111111
1111111011111101111111111111101001111111011111000111110111100101aaabbabaaaaaaaabbaaba101122220112111111011011011100101111111111010101111111010111111100111001111
1011111111111010111111111111101111111111111111111111111110111111a02212222111112001112112112222111110111001111111111111001111111111011101100101111011011111011111
0011111111110111101011101111111101110101111111110101111011011111a11001012022121012111120221220101110111111011111111101110101111111111101111111111111011111111101
1101111111111101011001101100111111110111111111111110110111011101a11122201010212202210211001122120111111111001101111101111111101111111111111101111001101011101011
1101110111111011111111111111111111111001101111110111011111101111a12110121110001102212221212220022011110111101001111101011001111111101111111110111111101001111111
1111111111110111010011101111100011110111111111101111111111011111a10211111002111120102201220111212111100111011111111111110111100101001010101111011111111111111111
0111111110111101011010111101100111111111111101110011101110111111a11210122222221202222011122201012111111011111101111011111101101110111110111011111111111101101001
0111111101101011111111011111111101011011111111111111111111110012b11211211121221202122212121222212111101011101111111011101111111111111111011111001011111011111111
1111110010110101111111010111110010101110111111111111111110001012a22121201212021211111111011012221110010111111101110111111111111111110111110111011110111111111011
1111011011111110001001111101111101111111011111111011111111101011b02201210011122211121102212201212011110110111111111111111011111001111011110100111011111111111111
1111111001111011101111100011111111011111110111110111111110101110b11121112220222001212202220221100111010111011110111011111110111111011001110111111111101110111111
1011111010000111111011001110111101111011011110111111111111110112b10212120012012122102210101210122111111101110111111101111110101111000101111111111101111111101001
0111101111110110110011111111101111111111111011011101111110101112b02102112122210210111011021221012111111111111011101111111111111111111000222021121212101101122221
0110111111111111111011111100111111111011111111111111111111101111a11122111021101000221022022200211111011111111101110111111110101111111012221211022221012220100210
1101111111001111101111011111111101011111111111111111110111111011a12211102100212121211221221122220111011011111111011111111110111101011202021022020212122121020222
1011111111111100011111001111111111011011110000011101111110111111a02201112211011102121222111220100111001111100110111101111110111111111021222222201011212021221112
1101111111101011111111100110011110111101011110011111010111111112b02111122112202220121212000101022111111111111100111101110111111111101122121221111122100011222222
1111111111111110101110111111011111111001011101001111001100110112b01221121222111121102211212120020101101111011011111111111111111111001102211021111112200012122122
1111010111111111110110011011111101111110111111111111110111111110b21121122202122210111011120102220111010111110111111101111111111111011210202122221110112220212212
aaaaaaaaaaaaaaaaaaaaaaaaaaaaaaaaaaaaaaaaaaaaaaaaaaaaaaaaaaaaaa12b20210101211222111121222102211121110111111110111101111111001111101011111210121111022120221110121
aaaaaaaaaaaaaaaaaaaaaaaaaaaaaaaaaaaaaaaaaaaaaaaaaaaaaaaaaaaaaa02a01110012201110111220212201122211110100101110011111111110011111111110202210221022121120111221122
101111101010111111111111111111111111101011110111111010111101aa12b22222121221100121122111011122120111111111111111110111101111111111111120102112002202111222020110
010111111111111110011111111111111111111111110110110111111111aa12a01022222221111122122111210022011101111110111111101011111110101110011121212111212111002120201011
101101111111111110000111111110010111011011111011111111111111aa11a00111212110212112111121211120212110111101111111011111111111101111111121112220122222222011211111
101111111111111011000111100111111011101110111111111111111110aa11a02112111011222222112102010221101111111111001101212122222100101012102100122202002221211121121111
001111011001111111100011011111101111110110111111111111011110aa11a22202121101012110122120211112112111111111111111121201211212211221200212010011220111212111122112
111001110111101111111000101011101011111111111111111011101011aa11a01201011120110120202002210121202101011101110111110112012012111201212221012111111022212120220222
011101011011111111101011111110011111111110111111111101111111aa11a12121122121012121202001101212112111110111100000101211121021121212210110210000212111220202220012
111110111011011111111111111101111111011100111111000110111111aa12a11222121221221210212202212221122111011111001011101210011020000222222112101122202022122202101222
111011111111110101101001010010101111101011111111111111111011aa10b11122122101100101220121112022112011111111111111110221210201002112112222212121011211122020121102
011111001100111111111010111110111111111111111111111101111100aa01a21210111022120022012221120220110111111101110111222221022121102212110221122112111212000221101212
111111111111111011111101111111111011110111011101111111111110aa11a12222020210220021102122221211111111101110101111111122221221211012111210121120222022212212112111
110111111111111011111011111110111001011111111011101111111011aa11b20212112122120102202102111202111111111111010111212012002011112102222221102122202111000012212021
111110111101110111111111111111111011011111111111110111001111aa01a02220010111221001112110210122111110111111001110120010120102210201122202121121122220200110112121
111111110100101101111111111111111111111101110111101011111111aa12a20212012001202122120210200012101111111111111111120122100122211001101010002111222102112202221120
111111111111111111111111111001111111001110101101111100110111aa11a21211100212122202211210211120111100110111111111222110221222221102122102221120101111112211121111
111111111111111111111011001111111111111111111110101111110111aa12b20110121110010211012112221222011100111111111010021112122121112211111121122112102112211211211102
111111111111111111011101111110111110111111111110011110111011aa12a11020222111211220011111021101110101101110111111012000220111212222112222222112222121221011121122
011111111111111111111011011011111111111011111110111111011111aa11a11101001111111011100110101111000111111011111110220211021022221222111121012220102101002120100021
110110111111111110111101101111010110101000111110110111111110aa11a11110101111111111111110001011101101111111101110121212201111102002101112112122102211011112122121
111111111010110111000010001111111111110100111111111011010111aa11a11111111110111111101111110011100111111111111101112110121111122110021211221110212100111111020101
111111111111111111111111111101101110111111111111110111110001aa11a01111111111111111101101001111111111010111111111102221220202021120112211111220211212121112111121
101111111111011111111110110111011111111101111101111000111111aa01a01110101010111110111110000111101011111101111110111220112012121202222122022222120001012102111002
111101111101111101100110111111101110111010011101111011011111aa11a10111110111011110101111110111111111111111111110221210221110201101020012011201201111111101110111
111111111111011011101111111111101111111111111111101111111111aa11a11111111110111111111111111111001101111101111111222222210210221122111222120122011110011101110111
101111011101011110111111111111111111111111011110011111011011aa10a11100111111101111110101111111101011111101111111212211211122212212122111221112011011111111110111
111011111001111001110111111111111111111110111111111101111101aa11a11000111111111111101111111111111011101110001011112212120012221011202211122121211111011110111111
111111100111111111111101110111101001101111110111111011101101aa11a11100111111111111101111111111101110111111010111222111020222101122102101122111111110111111111101
111110100011111010111111111111111111111111101110111011101111aa11a01110111010110101101111111110010111011111010111201022020211121112212222211112010110110111101111
011001101011111111111111111111111111011111100001101101111100aa01a11110111110101011011111111111101101110101110111021122112021222111022211212111110111111111111101
110111100101111111111111000001111011111111101111111111111011aa11a11100111110110010111111111111111111111111111111111211211211210121212210122210211101111010111001
101111111010211122001110112112012212201212111111111111011110aa11a11111111011111111011111101111111111111111111111010002112021211122121021221121111111111101111111
111011111110222021221111211111102122011211111111110110011111aa11a11111111100101111011101111111100111111111110111022021101221121011212012122212200011111110111110
101101111111021012211222220122211120101212111111110111111111aa00a11000111110110111011111111111101111111110111110222221111002211211111111101211110111110111111101
111101111112111220211221122111210122221211101111111110110111aa11a10011110110110111101111101011111011111011101011112120112021111220120212222202211010111111111101
111111111110211221221012122001202111112201101111111110101101aa10a11111111011110101111110111111011100101111111111001011110101110110111111101101001111010011111111
111110111011111002211221112211121222022111110111111111111111aa11a11111111111110110111011100101111111111111111111111111111111111011110111111111011111110110111010
010011111111221222211120111111210120110112110111111111111101aa11a11011111111111111011111111011110101011111111001101111111111111111111111111101100111011111111111
111011101012122111210211212202222111222111111111111110011111aa01a11110111111011111111100100111111110101111101110111011111111111111011111111100111101101111101111
111111101010202002121221002111112101111012011111101110111101aa11a01111111111111111111101111101101111101111110101111010011111111101111111101110111110101110110111
