96 0
49 154
93 44
111 45
63 75
39 142
52 110
95 74
56 142
69 91
1011100011011110111110111110101111111111111111111011111111110110001111101111101111101111101111111111011011111111111111101111111011011111101101111111111011101001
1111111110111111011111101111111111011100111110111111111101111010110111101110111111111011101011101111111110111110101111111001110110111101111101111111110111111111
0101111111111101101001100111111111111110100111101111101110111001110111111010110100011101001111111111110111101111011110001111110101101111111111111101010111111111
1111110110111111111001110101101111111101111011111001111111111011100111111111110111111011111111111111111111110011101111111111111111101111111111110110101111111111
1111101101111100011101010011111111101111011001001111011111111011011111111111110101111011011110111111101111111111111111101111001010111110010011011111111111010111
1111110111111110111100111111110111111011111111011111101110011111111111111111111111101111111100111111111101101110110111111101111111101111111110111010111001101010
100101111111011111011111111111011100111111011011111111111100110111111101111101011101111111111000110aaaaaaaaaaaaaaaaaaaaaaaaaaaaaaaaaaaaaaaaaaaaaaaaaaaaaaaaaaaaa
111101010111011111001011111111111101101110001111010011111011100110110111111011101111111011111111111a111110111111111100011110111111111011111111111011111101101111
111110101111100111011111111111011111011111111111111010111001101111111011111111111111101101011111111a111111101111111111101111110111111101101011111111111111111011
111111111110111110101111111111101011110110111101111111111111111110111111101111010110111101011100111a110111111110011111111001011111111101111111111111111111011111
001111110101111111111010011111111111111111110110101111111110011110111001110111011110110111011111100a110111100111100110111011101011111110111110011101111010111111
110101101100110011111111111111011011111111111111111111011101111111111011111101011111111111111111101a111111111101111101111011111110111111110110111101111011111110
101101101111110111100011110111111110011110111111111111110111101111111001110111111111111110111110111a111101111111111101111111111011110011111111111011111011101011
101111011011101111111110110011011110001011101110110110111011011111111111001111011101111101110111110a111111111100111111111110111111111100111111111110111001111111
111111111111111111111101011111110110110110110111111011111110011111111011101111111111110011101011101a111111110100111110111001111111001000011101011110111011111111
111111111111110111111111111101111101011111111110111111111111111111100111111101011111101111111110111a011111111010011111111011011011110011111111111111110101110001
110111011111101110110101111100110111101110111101011111001111101111111111011111111111111111111111011a111111101110100111110111101111010111011111111100001111111101
111011111111100111111111111001111110100111101111111111010111111111101111111110110101000111111101101a111111111111111011011110101111111101111111110111111101111111
111111111111101111111100011111111011101110101111101011111111011111011111111111111111101110111001111a111011001101111011111011101111101100111110010111111111111111
101111101011110100011111111111101111111111011111010111111100111110110011111110111111011111111111111a011111111111110110111111111100110111111110111111101110111101
110111110101111111111111111011111011111111111010110111011001111111110111111110111111110111100010111a111111111101101101110011011111111111011111111111111111001010
111011101111111111111111110110111011011111101101111111110111111111011111001111101111001111011111111a110111010011111011101111101100111110101110111111111011111111
011100111111111101111110001111110111111110100111011101110111111101101100101111111101011111111111111a011011111010101111110111111110110100011100011101011111110111
110111111111011110111111010110111101111111111111111101111011111110111111111011100111111111101101011a011011111111111011101111100101111110111111001111111111111111
011111101111101111111111100111111111101111111111110111111101111101111111111111111111111111111111111a011101111111111111101110111110101111111111111111111111111101
110111111111111111111011111111111111111111111111101001101110111100111111101111101111101111110101011a111111111100111110001011110111111111111011111111111101111100
111011111011111110101101111011101111111111111110111101011110111111111010100111110111011111111011111aaaaaaaaaaaaaaaaaaaaaaaaaaaaaaaaaaaaaaaaaaaaaaaaaaaaaaaaaaaaa
1111110111111111111110110100111111111111111011111110101111111111101101111111111100111110011111011011111111111111111011111111111010111101111111100001111111111111
1111011111111111111011110111111110111111111011111111111100111101111111110111011101101110111011111111111011110111111100100111011101101111011010101111110111011110
1111100111111111111110101110001111111111111111110010111111001111111100111101111011111011111111111101111110111101101110111110111111111111101111101111111111111011
1111111111111111011011110111111111111111101101010100100111111111111111111101111111111101011011011111101101110111111001111001001101011101111111111111111111111111
1101111111111110111111111010111011111111101110111111011011111101111011111110100111101111111111100000100111111111111111111000111111111111011aaaaaaaaaaaaaaaaaaaaa
1111111111101110111111101101111110011111111111111101111111111110110111111101011111101111011110111111111011011111010111111011101111111111011a01111101011101010111
1110111101111111111111110111111111101100011110101111110111111100111110111110111101111111111111101011111110001111110101011111111111111111111a11111111111111111111
1111111111111011111001111111111001111111111101011111101101111111111111111110111101001011111101110111111111111111111101111110101111111101111a01111111001111110101
1111111111111101001110111111110011111111010111111101111001011010111111011111111100110110110011111010111110111111000011111111001111111111101a01010111111110101111
1111111111111111101111101101111111111111111100010111111011011111010011111011111111110111011100111110011101100111111111111111011111111001111a11011100011011111111
0011101111111111111111110011111110111101111101111111000111111111111101101111011101011111111111111111100111011101011111101111011111111111111a11111111101111110101
0001111111100111110110011101011100100111111101111111111111010010011111111111011111110111111111001111111100111011110111100111111111101111111a01111110110110111001
1111110011011011101101111111011001111111100101100111111011111111101010110111101101110110111101111110110101110011111011011110111011111111111aaaaaabababaababaaaaa
1111101110110011101111111110111011111010110111111111111011110011111111110111111100111111111101111011111111011111110101001011111111111011111aa1010211111200101121
1111111111111111111111011110111000111111101111110010111011001111101111111111101110011111110111101111111101111010011111111101111111111011101aa1111222122021121212
1110110001111101011001111111011111111101111111111110111010100011111111111110111011111011111101111111111111111111111110111010110101010111101aa1112220221212201020
1011011111111111011101001111111111111111111111101110111111010111011111101111001111110110110111101101111111110110111001101111111001011111101aa1211121112112212021
1110111111011111111111111111111110111111111100101101111111101111111111011011111111111111111110111111111111101101101010111001111111111111011aa0222220001122212221
1110011111111101101111101110111111111111110111111111011110111111101111101111101111111101110110111111111111111111111111100101111111111111001aa1022121111112222120
1011001100111111101010011111011001111111111111001010111111111110111111111111111111110111111100110001111111011101111111011101111111111111110aa0111101111111110111
1011111110111111011110001011111111011010110111110111111111111111111001111111110111111010111110111011111110001101111111101111111111110111111aa1111111111111111011
1011011100111111111011111011001111111111101011111111011110111101111101111111111111101111111101101111011010111111111011111110111101111011111aa1220220221221021001
1110011001111011111111111101101011010111101111111101111111111111011111111110111111111101000111111110011101001110111011111111111110110111111aa0012111021102210210
1011000101110011110111110101111111101111111111010010111111101111111011110101111111111011110111110111111111101101110111111100101111011011101aa1021122212110211101
1011111101111011111111011111111101101111111111110111111111001111101101111111011011011111111111101110111100111111111111111111111111111011010aa1021122202021012002
0111111101111111111011101111111011111011110111010111010111111111111110111011111111101110111111101110110111101111101202122000201211211210110ba1121112101211122212
1111111011111111110011111011111101111111111101110111110011101100110011011001111111111111111111101111011101111120111001011102211222121201221ba1111111111101111011
1001111111000111110111111111111111111111111111110111111101111111001111111100010110111111111101110110100111111100121111212222221112220111122ab0022120112221201112
1011011011110011111010011111101111111111110111111001110111110111111111101101110111111111111111010111011001111120220112120102221111111212110aa1120011221002111102
1101111100111110111111111111111111011101111111111111011010101111111100111111011111001111111111111111111110111112012102220221120011011212002aa1211212201102112011
1111111111111111111111111111111111111011110111111111101101101111101111111111111111111111111111110111111111101012210000002202012222221121222ab0210122021222100102
1011111110111001110011100101111111110101001111100110111111111110111101101111111111101111110111111111111111101022002122201202022212212222200bb1201001222012012121
1111111101001111111111110011011101011111111111111011111111100111111111111111111001010011111111111111111110111121011122221022222111221220212bb1202111111011100111
1111011111101110111111111111111111111111110011111111111110010110111111111111111111110101111111111111011111110110210101002010011122211201120ba1212112011121022122
1110111011110111101111111111011111101011111111011111110011111110101111101011111110111111111101111110111010111110102121210202102110221221212aa1001111111111111111
1111111110101111101111111011111111100111111110111001111111111111111011111101111100110111110111100101110111111112101021220101111021000120212bb1201110220211112210
1101101010111111111111111101111111111111111111111011101111100111011111111111101212221121101121222101211202101100122111112221011111121101202ab1122110211110120202
1111111111111111011111111110101101110101111010001111011111101111111111111112122112112212201222222021200122111122222210021211221010121121122aa1111111110111001101
0101111111010101111111110111101111101100110011111111100111100111011111100012000020022012021110111222101122111002122102001202122122100222021ba1111122112112112211
1111111110110111011001101111111100100111111111111101111110101001101011111102120222202212102112002111012020111121221112211101021112110112101aa1010110001111111110
1101111111011110100100111111011111111011100111110110101101111101011111101111212212211212121211112222012212111122112121112111122212201002222ab1111112200021101112
1111111011111111111111111111111111011111001000011011101111111111111111011111212112000102202011021112022121111120012101021022012122220221212bb1111110111101101011
0111111111011111110001111111110110111101111111111111011011111111111001011111212211221211222110200012212211212101221202220120201110111112212aa0111111211201212221
1111111111111111111111110111111111011111111011111011101011110110111111111102220120222021020120211111222122112101212011121110021222020212022bb0211100211210222121
10111100110111111011110110110101101111101110111111111111111111101111101101102122020112202122220221212222121100122120221ababaaabbbabbbaabbaaaa1112112122102110122
11111011001111110111111011110010111111011111101110111011110110111100111101101112121011222001221211111112221211021211111b21212202021021121011b1001112120122112002
11111111011111111110101100101110111101011111111111101101110011111111111111122202212122221210112122212020120122200211122a21012201121121111211a1111110111110111111
11011111111111111101111111111101111111111011111111111111001111010111111111022221112212011110102201212212121121111102101a20212011120011112211b1012122121101221212
11011111110110111110111101101001011101111011101111011111110111111111101111021221212111221012212111121212021222102210022b01120211212021121202a1011121221222111121
01111111101111111111111110111111011111111111100111111111011111011111111111111201211001212120201110202210211102201220020a12202012221101111111a1101101111011101111
11111111101101110111111111111111111001111111111110111111011111111001111010112121221221221220010011110221220202020122202b20222212112102122100a1112111002202012222
01011111101111111110110111011111011101111111111111111111110111111111101111112220222210200120112121112221021221202122212a02221001112101102111a1112110202201022201
10111111010110111111111001111111110111111101011011111101111111111111111111101220211012202212211120212220211122211221110a00112001211101111101a0011111000111111101
10111111101111110111110111110110110110111101010111111111100111110111111011102120012211202212111110212211221121101222022a11102201211021121001b1222021212211122211
01111111011011110111111111101111100111111011011111110011111111101111110111112121100210211011122212120222221222121121112a22021102111110021211b1220012101111002220
01111110110110111111011110111101111111101011110111111011111111010101110011021111210101212012122200212110020210201110121a21012012111002111111b1111110111111110111
11111111111001001011111110111011110101111111111111111110111100111111111011102121121102012011201222101122212021102221120a12110111001111010011a1111100220020110002
10110111111110111111111001111011110111111110101101111100111101011111010101111221201221202212122122202122212021210122212b21101101110110111111a1120101121211022021
11111111111011111011111111111111111101111101111111011111011011111111101111122120112011221111012012201201111200121202212b21110111111110011011a1010100112021201011
11101011001101111111011111110110111110111111010101100111111010001111101111100212211102111222121202211111111122220221201a22111011111011111111a1001100201221100011
11101100011111111110001111011111111111111111111111111101110110101111111011022000011220112222111200101111022022211212112a11111111111101111111a1111101100111111111
01111011111111011101111110111110111111101111111101101111111010111010111111121121112212211111020210120222120221022220212a02111111111011111111a0111101111111111111
11111111011111011110111101001110011111111011101111111111110011111100111111111022122110011122122101011101111101112101021b10110101110111100011a1011111101111101010
10110111111110011111011111110101011101111101011111111111111111111111010111122112220121101110001221102121102221221221111b01111111100111111111a1111101111111101000
1111111101111111101aaaaaaaaaaaaaaaaaaaaaaaaaaaaaaaaaaaaaaaaaaaaaaaaaaaaaaaaaaabababaaabbaaabbbaaaaaabbabaabbbbbbbbababbb21111111111011111110a1011100111111111111
0011111101111110111a111111011111111111011111111111101111111111111011111001111000220111111101112212101121020122222021221112111101111111111110a1111110111110110111
0111111111111111111a011101111111111111111011211222121122122112121102211211222100202122212111120010010110121122112221212101100111011111111110a1101111111101110111
1111110111011011111a111111001111111111011111122010122121212012202222111120111111111101111111120012210121121111200121101111111111111111111101a1111111111111111111
1111111101101111111a111011111110010111100111100220222120211201121011210101002211122122110021001010211121121011122211212011110111011110111000a1100111111111110111
1111011001111111100a111111111011110001111111101111122220011211122121002220100220211000110221011110001121121202121200021012111111100011011011a1111111111111111111
1111111111111111010a111110110111111111111111221101112122112110012102211201011011100111221221121111211010121112122100122122111110111110111110a1111000110111101111
1110111111110111111a110101101101001101110111112012112211121010222111112201021011221210101021112202102021122101102011122121111011111111101111a1011111111110011111
1111111111011111111a111111111011011110100111011111011011011111100111111011aaaaaaaaaaaaaaaaaaaaaaaaaaaaaaaaaaaaaaaaaaaaaaaaaaaaaaaaaaaaa11011a0110101111111111110
1111100011011111111a111111011011011011110111112200112111111110110102112101a01011201211111010112212010011111011110011011111111111010110a11111a1111111110110111101
1111111111111101101a011111011100110011111111122111220121011111111201002221b01211122112110121021112210111110100101111111111111111010111a11101a1110111111010110111
1111111111111111011a100011110111101111010111101022212221211212111121102010b22110112212111111102110211111111101111111011011100111111101a01110a1011110111110101111
1011111110011111111a110111111111111011111111120222001012212212111221200000a11110221111111011111212112111110111111100011101111111111110a01111a1111111011111110111
1111111111111111111a111111110011110110110111101220122122122211101212111121b22211101112011101121212110111110110011011011110101111111101a11011a1011011111111101111
0111111011111110110a011111101110111011110111111000011121222102122201111101b11221221112111121111012211110001101111110111101101111010111a10001a1101011110111111011
1011011110111011111a011111001111101111110111120102210121221010122220010111b22221222112111000121111010100111111111111111111111111110111a10111a0111111111111111111
1111111111111111111a110111111011101110111011200002202122100212121122102120a11121212112121100122010100111111111111011111101111101101111a11111a0101111111110101111
1110001110111110111a011111011010111111110111222102022121122111102211211010a12021002211111121120110012111111111010111011110111111101101a11111a0100111001111111111
1110111111111111111a111111111110101111011101121101012221110210122120111221b11111112202121211112111112111111111011111111011111111111111a11111a1111101111111110011
0111111111111111111a111111100110111111111110121112012210222110111111001111b12101121111101100121210112110111011101101111111110111111111a11111a1110101111110111111
1111101111101010111aaaaaaaaaaaaaaaaaaaaaaaaaababaaaaabbbbbba11001101111011b21021211012110211122112100111110101111111110111111011111111a01011a1001110011111111111
11111111101111111111011111111101111011111101011112110122211a11011012112221a02011112012121211102011102011011111111111010101110101111110a01101a1111011111110111101
11110111101110111111111111111101110101011010200112212020212b12022122112220b21211111012111111102112211110111110111111110100111110111111a11111a1110111011111011100
11111101111110011101111110111111111111011110012111112221200a11021101212211a01111221212111021110011212111101101111110011101111011111011a11111a1100111111101111011
11101111110111110010111111111111111111111111111100112011011a11022122201221a22001120212111021102210002111011111111111111111111010101111a01111a1011100111111011111
10001101111111111101011111101111011111111111110112012222012b11111121212121b20111202011111011122012112110111001111111011111011001110011a11001a1011110011111101111
00110101100111110111011111011110101111111011212011112101012b11122021100211b12121220211111211121111210111011110111111100110111101011110a01111a1011110111111111011
11111111110110111101111101110111111111111011111011112111112a00112102011121a21221022210111021122102101111111110111111111111111111111110a01111a1111011111111111011
11001011111111110111011111011101111101111111201110011111012a12111111010021b11221020200021101102212212011011111011111110111001101111111a11111a1111111101101101111
