119 42
14 105
112 29
108 18
74 45
20 134
43 114
11 64
1 103
87 148
110111011111110110001111110110111101111111111001110011011100a111111111110110110111111111111111111111110111111110111111011111111111111111111101101111111111101001
111011111110111110010011011111111111111010101101111110111101a101111101111110111111111110111111111101111220102212111211202021211121112110111111111111110111111010
111101111111111101111111110111111011001111111110110110110111a111011111011110111011111111111111111111111020101111122200120212222122121011111111101111111111010111
010111111111111111111101011100111111100111111111111011011111a111111111111011111111111111101111111110111120112102101222110112221112222011111111101010111101011111
111110011011111111111110101110111110111110010111111101010111a011010111011010111101111111111111110111011222120221110111022020121121201010110001110111111101001011
101101111010111111111111101110111111111000111111011110101111a111111111011111110111111010111101011111111221201212122222020111222211221111110001110111111101111110
111011011011101101101111101110101110110110111001111111001111a111111110111111011110111111110110111001111222112121022120201222021122221110111001101111011111111011
111001111111111111111011111111111111111111101111111110111010a110101111110011101001111101111100110101110110211112111101010201222210110200110111111111010011001111
011111010011011110110110111111111111111110111111111111111111a111101110101110010011111101101111111111111221211211112122010112121221100211111111111011111111111001
111111111000011101111111111110011111110111000111100111111011a111101111111111111001111101111110111101011210212201221210222010122101011111001101011111111110111011
111111011111101011011111111100010111101111111011111111111110a101111111111110111111101111101111111100111121102110112201110222221210120211111110101111111111111100
100110001111111101111111111111111111110011111111111111111111a110221120112112211120211112221222011111100212121012011102212001210111011111111111111111110111110100
111101111111011111011110110101001110011111010111111011111111a111121022011111122022212212122200101111111201111101122221111211222222111110111111011111111111101111
111111111111111111101111111111110111111111111111111111110111a111000212202010202201102212112211211111111121211112122212120221210222111210101111101101110110110111
111111101111011111011111111011111111101111111111111111111111a101000001100122221111210211112220111011111221211021212112101102212220201211111001111111011111111111
011111111111110101110111111101001111111111111110111101111111a111222011111202012112111101211111011101110220122001011112221212211222122211111011111100111001011011
101100111111111001111111111111111101111011001111111111001111a011222202112021202221020011211222010111101222112211101120102020022112222201111111101111111111101111
aaaaaaaaaaaaaaaaaaaaaaaaaaaaaaaaaaaaaaaaa1111111101101011101a101110122211022101212210022212212111111101220222221122222211100212102121210111110111110111111111111
1101111111101111111111001111011111101111a1100101101011011110a111202121222201121222202222101101111111110100221212202221121212202111212111111111101111111011110111
1111111111110011111011111111111101111111a1010011111011111001a100122120222012121220021210122122211111011121220022221011221212212201112000101111111111111111111010
1111111111110111011111111110011101101111a1011111111001111111a110111120202122212021000121110101110101111200112212222022220001112202001122112002011202211210222211
1111110111111110010111101010010110010011a1110011111110111111a101021100222222110121112011020202210100010011010121111211212211211222222121222111212221222222111221
1111101111110011011100111111101110101111a1101111011111111111a110211010112122110002012011102121101110011110200112121022120012200121211102012212101112121212101101
1011111111111000111110101101111111110110a1110111011111111011a110121101021122112022101010121200111110111111212220011210122221022002202112122010112112212001012012
1111110110011111101010111111111101110101a1111000111111100111a111121120201120112210111112121121011111111222201120100110211222222212020012222210221101122211121111
1111101110011011111011111110110111111111a1110111111111111101a011120002122211111221122221202221111110110102221101222021222012210112112101102101002121012221222200
1111001111110111111111101111011111101111a1111111110111111011a111201212221212122001020122212112111111111121021122122202212212011121112201211221110222111111122222
0111110111101111001011111111101100110010a1001111001111111101a100022102101220102200222212021112001101011112101011122121221222212221110202211011011102001120011111
1110111111111101110110111110011111111110a1011011011111111111a110110212112212002111220111011121200111101122012211101111211021222111220111121022221110221202222102
1110111111111111101111111111111011111110a1111111111100111111a011221122112212222211211202211202211111111111110012221212122121110122212001022222222222012010121222
1110111101110111110111000111001110101111a1011111000011111111a111212022201211221211002212111102111111111201001002220012122112221202011101221012022122121021112221
1110111110101111110011111101101111111011a1111111111111111111a111112121212111012211222010122011111111010221110020012011201201112222212111022201212210222220102122
1111011110101110111111111011110111001011a1101111111111001111a111101211111122211220121220021211211101111111101111101111111111111111100000010211120122110220222102
1011111111111111101101111101111101111111a0111111111101111100a001221112221011011102111021121111211111101101111110111101111111011110010011222121121112011222120110
0110110101011111111111111010011111110110a0110110111111111101a111121112122012022122010021012221111111101001101110111111111101111111111112120021110120202222110211
1111111011111011011110111111011111111111a1111110111001111011a011101012212112211211202212212212011111111111111111111101110111011101111020002100111211112211000121
1111010111011111100110011111111011110011a1101111111111110111a111021002112222210100220101101212101111111101111011010111101111111101110102012122021111222202021112
aaaaaaaaaaaaaaaaaaaaaaaaaaaaaaaaaaaaaaaaa1111111110111111111a110101210102111111212111111210101211011101110111110111101111011111111111111001212022222210201210110
111101011111111111011111111011111110111111111101011111111111a011222221222002012121112201212110111111111111111111111110111111110010011112212121211212112120022111
111011111101111111011111100111101111011111111111111010101111a110101212122112102022111112120201210111111111011011111101111111101111110112112221221120121101112220
111101111110111010101111111101100111111011101111111111110111a111120021220022211122012011121011211111111011111111111111101011111111110012222211221121122221001112
111110111011011101110111111011110111011111111111111111001101a101222222012121221111102212002010111011011011000111110010110110111111101001221212110010222221201221
aaaaaaaaaaaaaaaaaaaaaaaaaaaaaaaaaaaaaaaaaaaaaaaaaaaaaaaaaaaaa011111110111111010011111001001111111111111011011110111011110111110101101111121222111212001011111212
1010010011110101111111010101111111110111111111111001111111011101111111011101111011111111001111011111111101111111111121012120212102012111021112121001110202222022
1110111111100111101111001110110111101111111111111111111111111111101111111011111110111111111011111100111011111111101111111110110110010111111112221222111212021212
1110110101111111111111110111111111111011011011111110011111111011111110111111111001111011111111111111111111110111112121112212111222220220121112122121202011122111
0001010110111111011111101111111011000100011110101111011011010101101110111101111101111011111101111111111111110111100012121211221112222101201112221122122211202100
1110111000111111111111100111011111100111001101111010110111101111111111101001010011001111101111100111011111010111112120121011211212201220121111002222212222212210
0111110111111111111111111111011110111111111111111111111111111101111111111111111111111111001100110111110111011001012200011012212211110221011111002022220111210012
0110101111111101011001011011111101001111111010111111101010111111111111111111111111001111110101011111111011110011112221111111112112220122212011011111222201111212
1111111011101111111111101100101111101111101101111111011010110101100101111101111110111111110111101111100111111110011022011201220211222112222012020211111120212212
1111110111100011011110111010110110010101111111111110111111111011111101111111101101101011101011111111011111111111111111110111111111110101111012002111111100111111
0101010110101111111111110111101111111111110111111111101111111111111111100101110011111011110011011111010111101111010112120001222210211221111112120101111111110111
1111001111111111111011101111111011111111111010111110110011011111111111111011111111111111111011111011111110111111102102221211222112210102221012221111101111111101
0110111111111111011101111011101111011110111111111111111011111111111111011110110111001111111111111111001111111010112222111121021122222222022210211111111110110111
1011101011101111011001111111111111111111110011111011110111111001111111111000100111111110111111111101111111110111110112112201112221222111120202221101111111110110
1110111011111111011101101101111101111001011011111010110101111111111110111111111100111111111111111001111111111111112111102211122012010202022012122111111111111011
1011111111111110111110111011011111101111111111111111110111011011111111111111101111101111111101111101111101111101011122111011221102111001121011211111111111110011
1111111100111111111101011111111111101101110111111101110111101111111110101111111111111111111111111110111111110001011220120211221010221211122011101111011111001011
1111110111111110111111111101111110111011110111011100111111111111111111110111111111011111111111111111111111101111100212220000111212010122201211122101011111111101
1111111111111111111101111111111111111111111111111110110011111101111011101111111111111111111111110110111111111011111102122122111221212212111012112101111010111101
1110011110110110111101111111111101100100111111101011111111111111111101110111111111111101011111111111111111110111101002212002122111222122202212122010111011111111
1111111001111111001111111111111011111010011111001111111110111101111110111111111111011011111111101110111111111101012011021222012212012201111111222110110110111111
aaaaaaaaaaaaaaaaaaaaaaaaaaaaaaaaaaaaaaaaaaaaaaaaaaaaaaaaaaaaaaaaaaaaaaaaaaaaaaaaaaaaaaaaaaaaaaaaaaaaaaaaaaaaaaaaaabbaabab121221122221022211010221111111111011110
100111111111111111101111011111111111111101111110101111110101100110110111111010111111111111111111101111101111110110221021b021102122110202112112101011011111111110
111101100111111101111101111011111111110101010111111111011110110110110100110011101101110011111111111111110111111101111221b100222001122201202211121111111011111110
111111111101101111111101100001111111111011111111110111011111011111011101110110101010111111111111111111101111110101200212a210221221212120220110112111101101101111
110100111110110111101111111111111101111001010110111111111101111101111011111111011111101111110111111110111111011111212122a221221211112201202112122111111111111011
111111001111111100111001000101111110011111011011111111101100111100011111111111111110111101001100111101111111011111110120a222212202111011002111002111011100111001
111111111111011111111001110110010111110110111111111111110101111110111111111101111011110111011101111111101110111011112202a001212010222022022201111111101111110101
111111111101111111101101011010111111111110111111110111111110011010101111101111100001101111110001111111111011110111112121b111011222220112112212021111101001111111
110110101101011110111011111111111101111011111111111111111110111101101110111111111111011111111111111111111110110111200020b021221122101122211211220011111111101010
111111001100111011111001111111111111111111101111111111101111011100110101111111111111111011101101110111011011111111222121b112110111220010122111022111111010001100
011111001001100111101101011011110111110111111101111111111111111111111111111011101001111110111110011111111111100111210011a111101012102102021211111101011110110111
100111101010001101111111111010111011100111111022121011112110222221111212222111111111011111101101001111101111110111110110a111111111111101110111111001111110101101
011111111111111101111011111111111110111111111111102210111212012222010222101211111111111111111111111101111111110111111111a111111110001011111011100111111111110110
111111101111110000111011111111111111101101101100222222122122211012122112121010011111100111101011011111111111111101101111a011111110111111111111101011110110111010
011111111111011110111111101101101111101011111221210101212210221222011012212111010111111111110111111111110001111110111010a111101110111111111010111111111100110111
111111111101110111101011111110110111111111110121122002220211020012122201101211111011101011111111111011111111110111011011a001101111111111001110111111101011111111
101011011111111111111011111111101101101111110202201200121102102111111110112211101011110011111110111111100111110010011100a111111011010011110101000000101110101111
111110011110111101111111110111111010111111110100100112112112111202202012111210110111101101101111101110111111110111100011a110111011111011111011111111111101111110
101011110101111111011110111111111111111111111111110111101010110111111001111011111110111111111101100110101110111111111111a101011010101111101110111110101111011111
111100000110111111111111111111001111111101111222212120211212112210021211020111011111111111111011001111011111101111001110a111110011100111101111110111111111101101
111000111111011111101011111111011111101001111100012122221020220112122122021111010110011111101111111111111111111110111110aaaaaaaaaaaaaaaaaaaaaaaaaaaaaaaaaaaaaaaa
1111110111111111110011011111111111101110111112101112021121210222000100101202011111111111011011101111111001011111111111111101111111111011111101110111111111111111
0110111111101101101101111100100111101111111011102122122111222021220011121110100111011111111011101111110101111111101111011111111110111111101111110111111111111111
1111111111001110111011100111111111011111101110121122011112211111120221211121100001111011010111110111111111111111111111111010101001111111111111011111011111111100
1001111101011100011100110111111111111111110111210001101211102221110221122112011101010011110101111110101111111110110100000001111101111101111111011101112210221121
0111101111110111111111011110111111111111111111211012212011201101211121122200111111101101011111111001111111011011111111111111111111110111100101101111202212102102
1110101101111110111111011011111110011111111112112120112102201021121222100111111111011001111101111111111110111111111111111111111111101111001111010110012211220122
aaaaaaaaaaaaaaaaaaaaa1101111001111111111aaaaabaaabbabbabbaaba112211101012210111110111110011001101111111111101100010011111111111111010111111111111111100111111021
11101111111111100111a1100001111101111111a1011122122112212122b221101222212102011111011111111111111111111011011100001011011111111111111011111110111111112102102210
11111011101011110101a1111101111111011100a0101111221021011111a012012110022122011111111010011111110001111111111111100111111110110110110111101111111111102211212211
11111111111101111011a1011111110110101111a1110210122222101201b221202122212121111111111111011101010011111111111011011011111111100010111011101111111101021111122201
11111011111111110111a1111100111110111111a1111011121011110122b111012111102212111111111011110111111101011111110111111111111110111011111011001111111101120002111202
11011111111111010101a0101111111001110111a1101122110222021111b121122011111012111111111111111101011101111011010111011111101111111111111111101110110111202211211121
11101101110111111001a1101111100110111111a1111012010201201021a211101121000121011111001111101011111111101111110111000111110101101111111111100101111110120210222222
11101111101111111100a1111111001111111111a1111210210001112210b112102212122200110110011011101111001111111111111111000111101111010111111001111111011111212011221211
11011011110011101111a1111101111110111111a1101211122122100222a210111011211211111111101110111110001110111111111011100111111010111111111011111111111100220120102112
11011100111011111001a1111111101111011001a1101122121210111122b110110102101112111101110011111101011110111111010111111111101111111011011111011111111100222222220111
11110111011011011101a1101111101111111111a1111210112221212211b121222222221222011001111110011011111111110111111011011101101101101001111111111111001111221111220102
10101111100100110110a1011111101111110111a1111202222222111121a111001110111100010111011110011110111110111111111001111010100111111111111111111111111111122120012111
01111101111111101101a0100011011111111110a1110120101222122120a212222010122010111111101111111110111111111101111011111011110101011110101111111111110111221201221021
01111111111110111010a1110111111111010101a1101221212110121120a111121101110121111111101011111111011011111111111111111100111110011101111111111111111111222211221202
11111110010111011011a1111011110010111010a1111221112210121110b111001122122202111110010111010011011111111111101110101101011111111111010111101110111111111111220122
10111110110110111101a1111110001110001110a0111101111111111011a110111011111111011111110011111111111010110111111010111010111111101111101001111111111111011221212111
01111100111111011011a0111011010111111111a1111011111111111111a111010111111111111011101111111111101101111110111111111101111100100011111011111111001111001221211201
11111111111011110110a1111100101101101111a1111010111111101111a111111111110110111111101111011111110110011111111101101111111111111111111111111111110111022011211200
01111010110101011100a0111111111022212211a2112212111111111000a110111011100111111111101111011111111111111101011111011011111111111011111001010111111011110121212211
11111001101111111122a0220000121212220111a0211110011111111111a111101111111111011111100101111111111010110101101101111111111101111011010110111111011111221110211211
11111001111111110111aaaaaaaaaaaaaaaaaaaaa0111101111111110111a101011111110111101101100110011101111101101011011111111011110101101011111111101110111111012121111211
111111101011011101111222012222210201120110011002211100111111a111011111101110011111101111111011101111110111111101111111111111111110001110111101110101122100020122
101111111110111111001110111111100101111111011111111101011100a111111100111111011110111111111101111011101111111011101111111111101111111100100011111111111101220212
110111111111101111111110211102221202021111210201222021120221a100111110111111111110011101111110011011101110110011001111111111110111111111111111110110210222221121
111110011011101101221120202210122012111211110102221110212021a011111101110111001101110110111111110110110111111111111111101110111111010111110111111111210212122122
101110001101111111221110012122020212121212221100210110110211a111110101111101100111110100111111011111111011101000110111011111011110101111111101111111212111022211
111111111111111011111111100101111010011001011111101111011111a111111101111101111111111111111111111111111001111111111111111011111101111111111111111111200011102122
101011111111011100020111221222201111111021211012202210111011a111111111011101111111110101111111101011111111111110111111011111111110111110111110111011011222221120
111111111110010101220210222022111022121121011111211221211122a111011111111101101111111111111110111011111110111111111100011011111111111111101100111111111011111111
110111101011111111111011221111022212211121220122212210121120a110111111001011011011111111110011101101011011111111111101111011111101111111101111100111011011111111
