109 42
62 139
107 32
117 21
55 143
88 138
29 118
37 17
76 10
17 91
10111111011111111001111111111111111111a111111111110111101010a1010011011101111011110111110111111111111111110101111111001a1111111111111101101111011110101110101111
11110111011111111111110011111111111111a101101011101011111111a101111011111111111aaaaaaaaaaaaaaaaaaaaaaaaaaaaaaaaaaaaaaaaa1101110111110111111101011011111111111100
11110101101110101111111010101101111101a101111100110111011111a111111011101011001a11100111100111110111111111001011111001011110111111100111111111110111111011111111
00011111111111101101111011101110111101a111011111111111101111a111101111111111111a01111111111111111111101111011011111011111111101110101111110111110111111110111011
10111010001111110011111110110101111000a111010101101111011010a011111111111011111a00111111111011111110101111111011111101111111111111101110101101111111110111111111
00011111111100111110011111111111111101a111110011011111010111a111010111101101111a11111111110011011001111111110111100111110111111110100101011100011101111111101110
11111111110101110101110011111110101111a101111111101001111111a111111111001111111a11010111111011111111011101111111101110001110001111111111111001110100110101111110
11111101111110110101111111111110111110a111111111001111111111a111111111110111011a11100011011111111111111111111111110101110010111110011110111111110111111111111110
01111111111111110010111111101001101111a111111000111111111101a111111111111111000a11111111011010110110111111100111111101101111101101010101111100101101111011111111
11111001111110100110000111001111111110a111111001111010110110a011110111111001111a11111011110111111111011011001111010101111111111101111111111111110111111111111011
10101111011101111111011111110111011110a001101111110110111101a111110111101111111a01111111111111110111111111110100001101011010111111111111111111110111111101111111
01011111111001110110111011100110101101a111111111110011111100a011111111101011111a11101110101111110111011101111011101111011111011111111111101111101111111011111111
01111111001111111111100011111111111101a111011111111111110111a101101110111101101a10111101100111111111111111101001011111110101111111011011111111110111111011111111
10111101110111111101110011111111111111a111011011110111001111a111111111101111111a00011111111011111111111111011111111111111101011010111111111111111101111101101011
01111011110111111111111111111111011101a111011110110111111111a111110111111111101a01111011111101100111110111011111111111111001111111111110111111101111111110001110
11111001111111111111011110111111111011a101111011110111111111a111111111011111011a10111001111110111111011111111101111110100100111100111111110110111111011111111111
11111111111111101111101111111111111111a011001111111011111111a110011111111111110a01111111111001111111011010111101101111111111111101111101111010100111010111111111
10111110101111011111100110111101111110a111111111101111111110a111101111110101110a10111111111021111112212110022221112022111201111111010111011111111111111111110111
10101111101111110010111111110111011111a111111111111111110111a111111001001011111a11111011000120122121211211112102121211101111111101111101011011111011010010001011
10111111110111110111111101101111111111a110101011111111011010a111111111101111010a01110111101202202211101212112122022111201211010111111101111111001111111111100111
11101100011111111111111111111111111101a010111111111111111111a111111011010101110a00011110111100201222202102111002011102211011111111111111111111111111101101111111
10110111111001011111111111101110110111a111111111011101101111a101111111110111111aaaaaaaaaaaabbbaaabbbaaaaaaaaabbababaabbb2211111011111110110111110111011111110111
11111011111001101101111001111110110111a110111011011111111111a1111111111111011011111111111112020221221012112111112112012a2111011111111100111101110101111011111011
01111111111110111101101011111101111001a111001110101101101111a1011111011111000011111011011112212201112201220001112210002b1011010111111000110101011101111111011110
11111011111111111001111011111101111110a111111111011101111111a1100011011111111111111011110110221021221021121110110202122a1201011111111111110011111100111011100101
10111111111111110111010010110111110011a111111111111110010111a1110011101011111111101111111110120202211110121201212112212b1111111110011100110111111011110111111101
10111110110110111110111111110111101111a011111111111011111111a1111110110111011111011111111112120221221201221201211111121a2210111011111111110111101011011110111001
11101111011011111011011111001000101111a111101111111110101111a1011111111111110111011111101011222122201110122022020122021b2111111111111110111111111111110111101111
01011111111101111111110100011011111011a111110110111111111101a1111111011111011111101111111112211112122112211222022212211a1210111111100110101111111000101111110111
11010011101111111101111111111111111111a011111111011110011101a1111111111111110110111110111112211100221001211101211112221b1111002212121212212112221122111111101000
10011101010111010011111011110101111111a111111100110101111111a1111110111111111111011111110112112211112112122221011222121b0020121102121210012220120122211111011111
11111001100111111111111111110101011111a111111110111101111101a1001111011111111011101110101112221121221221011110221122011a2011012202211212121202110101011101100111
01111111010111111011111111111110001000a111110101111100011101a1111111111111111001111101011111122110010101111010112002201a2010200222022222202112022210101111100111
11111111011101101111111111011111111111a110101011011111110011a1110010011110111111110101111111221122102101211221101122201b1210220202122221222011111212111011111111
11111111011111111111010001101011111101a101111111111111010111a1110000010111111111010101110111221222112222212112222121201b2020122002011112222211011212110111110011
11010100111111111111010100111111101111a011111111111111110111a1111111111111111111111101111110002112210111111211200121220a2121011211111111201001020212211111110111
11111111111111111011111111111111111111a111111110111101110111a1111111011101111111111110011112111121102012022202210022112a1121222221100122111121122222101011111111
10101011010111111121012122122002102101a112110222111111111111a1110111111111111111111111111112222201220121102110122211211a2120110212100211210022202101111111111001
01101111111111110112110120112222211121b120121111111100011101a0001111010111111111111110000110222102202112221100122220212a1121222112010222122021221102111101111111
11111110101111111111210201110111011111a011001100111111101111a0001111111000111111011110110102121110021221011220221120201a2221221021212221202120102210201111111111
01101011101111101111001111021022110111a111110111111111111101a1101111111111111111110011111001011111110111101111110101111b1001111111111111111111111111111111111111
11110111111101111112111221212111022220a212111121011111111001a1111011111111110111111110011111111111121110111221221001211a2222221210111201011baaaabbbaaaaaaaaaaaaa
11101011001111111002201101112220122120a122121111111111110011a1100111011011101111011010101112211110120012222001112012201b2222002120221222111b20111101210001111011
10111001111110111110212221102101111212b112221100001101111111a1101110111111111011111101111112201111112122011110221012110b1220201110111112222a01021221200110110011
11111111111011111222121121221120120220b121211222110101111111a1111110111111110101110011101002222200221100110212112011200a0201111111221112121a21212122010101111110
10111111111111111202212111121012211111b111200111101111011111a1111101111001100111111111111102022122220022011111022210120a2021222201201211000b12200211111111111110
01111111110111111111211011212222121212b222002212111111101111a0111011111010111111111111111002102121112211121111211112220b2200101202111012112a20101111201101111101
10001111011111111221012221112012221201a211222111111111111111a1111111101101110111011111111011201102021002211221211121001b1222111101211120221b20220220111001011110
11111110111110111122022021212121012222b210111211111101011111a1110111111111101111011111001111101011111111111101111101112b1021210201021222201a00221220111001101111
11111110111111111122222111202122111110a122211221011111011111a1011111001111101111111111111001011100010101111111111110111a1120122212201102222b10120201111111110011
11011111110111110021202020121110212110b011102112111111110111a1101110111111111111111110111011011010101110111111111011111b1222122101221202211b11122222111100101110
01011111010011001110010221122220201112a222220120111111111111a1101111101101111110011110111111001100111111110101111111012a1112211122210121212a22211202210110111111
11101100101110110222221021011221212111b020211011111111011111a1010111111111111101111111011111111111111011111110111110011b1221001021221111011a12020211111101101111
11110111111110101102022111101021121201a122202222101111001101a1011001111110111111110111111101111111010101111111011100011a1001112200121222100a22221200211001110100
11111101111101111221012211101112202111a212000122101111111111a1111111001111111111111111011110111111001111111111011011111b2111211220010112110a11111222011011111111
11101111111011111112012100111101122202b200112222111111111001a1101111011111111111111111111111111111111111011101111111112a1022122012011211111a12011011212100211010
11111111111111110122012111221211010122a121120210011111011111a1101111111111100101101111011111010111111111111001011111112a2022221221121202202a02012210021111221120
11110111111011011221211201022121011022b111000122101001011111a1111101110010111101111101110101101111001001111111111111112b0211101101221202102a12111111211220020112
11100111111101101021112111221212220111a102021020111111011111a1111111101101111111111101011111011111101110110101101111010b2202210221211212022a12222002102112011112
11111111111110101001221100012102222121a102212210111111111111a1110111101111111110111111011111111100110111011101111011112b1221112221111202202b02001222122122102001
01111101111010110101022221221101011221a102101221111111110111a1111011111001011110111011111111101110111111111111111101111a1111111111001111111a10112212222102212221
01111111111110111210122201012210120221b120221222111111111011a0001111111110110110111111111111011111110111100111111111111aaaaaaaaaaaaaaaaaaaaa10101112222002112210
11101111111111011001022101221111222201b012211011111111011111a110101111101111111111011111111111111111110111111000111111111111111111111111111111112000120221210202
01111111111111010111221201222102022221b002221112001111111111a111101111111101111101111111111111111101110101011111111111111111100111111111011111122022102122112222
11111111111111101201212021022212120010b220112122111111101111a111010110111110111111111111110111110111111111111001101111011011100101001111111011111211210122112021
11111110101011010122000221120212111112b210102120111101111111a011111011111111010111111011011111001011111110111010111110101111011111111111101111101222121001120012
11011111111100011120211101012121201010a212212001111111111111a111001111101111111100111111111100111111011011101111111110111111111111111010111111121222211211220121
11010111110101111022102021102202222002a021022111111111111111a110101111111111111001110111111011111011010011010111111110111101001011111101101111121112111102221101
11110111111111101111101110011111110111a111011111110111111111a111111111110010111111111110011110111011110111111111110111101110111011111111111111121221121210210121
11111010101111101111011001111111111111a111111111011111011111a110111111011111111011100111101011100111011111110010001111101011111011110111010001121110102222211120
11100111111011011111101111011111111111a111111101111101101111a110111011111111010111111011111111110011101110101111111011111111000111111010111110121121021112211110
11111101011110110100111111111110100111a011111011111111011111a101111111111110101110110001101111111111111101111111111001111111111101110110111111111212001112122211
01111111011111111011110111101010101001a000001011100111100101a100111111111111111101011111100101111111011111111011101011000111110100111110110100111120211102112101
11101110110111011110111101111111111111a001110111111110011011a111101111111111111111101111101110011111111011111001111111111111111011111110111110111211012111120200
11111111101110110111110110111111011101a011111111011111111011a111111011111111111001011010011111111011111111111111110111011110111011111100011011101100202021121221
11110111011110111101111111010111111011a111011101110111111111a101111001101011110111010110111011111010101111101111101101111011111111111111011111112111201221100221
01101111112102101111212211112102210212b020111110111111111111a110111111011111111110111111111010111111111111101101111111111111101011011011101111101112212122221111
11111111111202221122122110200211001112a211100100110111111111a111011111111101111111111110110111111101001111111111100110101101011111111101111111101212101121021212
11110111002012212102001211202110222112b120111011110101111110a111111110010111101011111111111110111101011011101111111101001111111101110111111111110200200102212021
11111111112201112111101221221111000210b1aaaaaaaaaaaaaaaaaaaaa11101111101110011111001101110111011111011111010011111110111110111110111011aaaaaaaabbabbabababbb2211
11111111111121220121012101112122202121b2a0111011111111111111110111111110111110111111110111011111100011111111111110111101111111111010110a0111111202220100222a1221
11011111112121221201222211200010212000a2b1101111111111111111111011111001110011111100101111001111011100011000110111111110110111100111111a1111111111221112121b1211
11011111111112122121002201022222122221b2b1111111101111101111101111111111011111111100111111111110111111101111101111110111101101101101111a1111111001211112222a1200
11011110112101100200012020211212121122b2a1110111101111111101101111011011111111101111101101001010101111100111110111101111111111110101111a0111111111112202100b0211
11101101110011002111222211112112121212b2a1101111111111111110111111101111011110111111101111110000101111111111111111110011011111111011011a1111111211212222122a1111
10011101110112211122202121212222011211b2a1111111100011111011110110111111110111111010001111101111011111111011111100011111111111110001011a1110011111001211110b0001
11110111111201201022211101011121221111a1b0111110111110111111011111111101011101110011111111111111111110111111111111110110111111111111001a1111111011111111111a0111
01111011101221211222221120121111111200b2b1111111011111011111111111111111111111101111101111100111110111111111111111111111111011111110111a1111111111110111111a1111
11111101010022001201201011101112122112a2b1111111111111110110110111111111111111111111101111111101111111110001111111111110101011101011111a1111220221202121002a1021
11111111110220201212202111112222121212a2b0101110011011101111111011011111111111111111100011011011101001111110111111110111111001011011111a1112022212120222011a1220
10111101112222121121112121221112020222b2b1011111101111111111101001111011111111011011011101111111111001111111111101111111111111110011110a0100122112122121121b0212
11101111010121222121202001221102002212a1a1110111111111110111111111111111111111111011111110101111110011001011100111111111110111111111111a1021220012120012221b2120
00111011112102012001022221122112020010a0b1111111111111101101111110110101010100111111101101111011111100111100110111111110110111111111111a1112202212120201110b1101
11111010112222112212111121212212111112a2a1111101111111110011101111101111111111101111110111001110110111111111010111111011111111111101111a1122022012122222010a1021
01101011111122112122012121121112121102b2a1011111011111011010111101110111011111101111101001010101111101011111111111111100111011111101011a1122211211101002011a2122
11111011111211111210221201021121121111b0a1111101111111111101111111110111101111101100011010100011101111111111111011111101111111110101111a1111121211120211101b0112
10111001010102201121001221122222112220a2a1111011111110111011101111111110111101010101111111101111111111011111110110101011111101110111111a1121212002211111222b1211
11101101111101111210212001221021220211a2b1111111111111110111001011111111011011110111111111111111110111111111011111111111111010111110010a1100121112122121121a2112
01111111111222122102122121211010202122b2b1011111101011111101111100110111011011111111111011111111110101111111011101111010111111111111111a1000002011100202221a2110
11101000012212111101111121222221011221a2aaaaaaaaaaaaaaaaaaaaa1111111101001111111111111111111011aaaaaaaaaaaaaaaaaaaaaaaaaaaaaaaaaaaaaaaaa1112020022112100011b0100
aaaaaaaaaabbaababbbaabbbaabaabaaababaab101101101111111011111a1011111111001111110111111111011111a01111111111001111111110111111111111111111122211121221111122b0222
111111001121221210012122212102112001022211111111111110111111a0011111111111111011111110110111011a01111111111111110010010111111010011111111100222221122111110b1120
110111111111021101210212200022011222122221110110111111111110a1111111011101011111111111111011111a01101110011011111011110111111111110110110122212111221101212b0012
111110110111112111111102212112112122111200111111111111101111a1111101111111111101111011110111011a10111101000111111110111100111111111101101101012222211211111a2111
011110101122102121221122110101111211221001011111101111110111a1110111111111111111011111011011111a01111111110001111111011111111110000111110112121111122211111a0022
111011111121100212122212211222111222101121101111100111010111a1011111010110111100011101110011100a11111111111111111111110011111011111111111111222201210212112a0211
111101100122201121101120011121021120022211101011110111111111a1111111011010011111101111111111101a11111110100111111111001011111111001111110121112111110122001b1102
111010100100011011011111111111111211122211222002212200222211b1111111111111111111111111111111001a11111111111110111011111111111110110111110021022221212120000b1222
111011111111111010111111101111011211001201012101120121121112a2111111101111111111111111111111111a11011111011110110110101011011111111011010112020211211112101b0221
111111101010111011011111111111111102111222122220202112122212a2111111111111111111110111111000111a11111111110011010011110110110011111011110120012222210111002a0211
111110011110101101110001111111010120112120221012122212121121b2111110111011011111110101100110111a10110011101111111001111111111111101101111012212121212202012b2100
101111111001011111100011011111112121002022202210221011122120b1110011111100011101011100110111111a10101101111110111111110110101111111011101120122112012210210b1011
010111111111110111111111111001112211211121222221201111202212b2211111111111111111011111011101110a01010111110111111111111111111011101111101102100000110111012b2212
011111111111011111111111111111111112102110021000200220121111a0111011111100111111110111111111101a01111111101111111101111101111011101111101000100112202021210b0111
011111111111010010111011101011112211110122120021122121012201b0001111111111111111111011111111111a11011111011101011001110111101111111100111112121220122022100b1211
011000101110110110111111111111100202221222022122212202122210a2110111111111011111111111111110111a10101111011101101111011111111110011101111011122222011010012a1122
111101111111101111111111111101111020112121010102222120212011b0001111111111111101111111111111110a11111011111111111101111011011111110111011111121222222111022b2220
011111011011101111110222001212012221211120112121202111122200a1101011110111100011101111110101111a11111110111101111111111111011111111111011122122121110111102a1101
111110100111011011111112110120211111121112220102201211201100a2211001111111111111111111011111111a11111111101100111111011100110011111111111100110222202221021a0021
101111011111111111101012200222212112011220121022222121110111b2011111111011101111111111011111111a11111101111001111010011011111110101101011111011011111111110a1110
