93 15
10 141
79 22
33 25
19 76
109 19
117 59
36 4
71 38
75 148
1111111101101011111111111111101111111a11111111100111010110111111110111111111111010010101110111111111101101011011110100011011111110001111101111011111101111110011
0011110010111011001111111111101011111a10011100111110111111111111010111111111111101111111001111111111111111110111111111001111011110111011111111110111010111110111
1110010101110011111111111111111011011a11110011111111110111111111011111111111110011111111111001011111111111111111011011111111101111110110111011110111111101101110
1110111101110110110111111111111111101a10111111111111111010111111111111111111111101110100010011111111111010111101111110111111110111101111110111111110110111010111
1110010111101111111110111111111111111a01001111111010100110111110011101111110001111011111000111011110111010111111111111110111101111100010111111100101101111111110
1111111111111111111111111111011110011a11111111110001110011011111111101111111110111111001111111111111011111111101111111110100111111110011011111110111101101111100
1111111001011110111111101111111101111a11111111111010101101011011111110111111110111111110111111000011111111110111111111111011111111111101011111111111111111111111
1011010111111111101101111111111111011a11111111110111111111111111101111110110110111111101011110101111110111101110011111011111101011011111111101111001111111111101
1111111111111111001110111101110111110a11011111011101111111111101100011111011111111011111111011111001111111111111110111011110111111100111011111111111111111101011
1111101101111101111101111111101111101a01011111111110111011011111111100011101100101011001100100001111011101111101010111111111011111111111111010111100011110111111
1111110111011111110111111111111011111a11011001111110101111110110101011111111101110111111111111111011111001111111011111111111111111111111111111101111110111111111
1111111111011101111101101011111110111a11111111011111111101111111111111111111111111101111110110101101110111111110111111111011111101111111101111111111111111111111
1101111111011111010011011111111111110a11101011110111111111111111101111111101101001110110110101111101011111111111101110011111111111111111111111111111110111101111
1110111111111110111001010111111111111a11111101011101011101001110111101111111100011101111110111111111111110111111111111101011111111111011111101101111111000101111
1011101111101101111111111101111111111a11110011111111101001101110111101110110100011111101111010111111010111110111111111110011111111110101111111111111110000111101
1111011011111110111101011111111011011a11111110111111111111111110101111111000101101110000001011101111110110111111111100111011111110111111111110100111111111111101
0010111111111111011111110111011111111a11111101111101111010101110111111110110110111111111111010001011110101110010111111110101111111101101111111100101010110011111
1010100111101011111111110111110111111a11111011110011111011101111111111011001110111111111101111011011111111100111111011111101111011101101111111111001111111101111
1110011111100111111110110110111111111a11111101101101011111111001111101101111111111111011101101001100111111011011110111101111011111111111111011110011100111110111
1111111110110100111111010110111001111a11aaaaaaaaaaaaaaaaaaaaaaaaaaaaaaaaaaaaabbabbbabbaaabaaabababbbabbaabaaaaaaaaaaaaaaa101110101011011101110011110001111101111
1110111110111101111111011111111111100a10a1111111101101111001111101110011101111121212121102120212211220122221010111111111a111111111011111111111111111011011111110
1111111011011001111110111111110111111a10a1111111110101011110111011110111111112111111101121211101222220121221111101011111a111111110101111011011011111111010111010
1101111001111111001011101010010011101a11a1111011011101111101011111010111111012022221211220022212122211111121111111111101a110111110111011101111111011101111111111
1111111111111111110101011111111111111a11a1111110010110111001101111011110111121100122121101022220101120120221110111011111a011111001011111101111010111111111111111
0001011101111110111001111111011111011a11a0011101111011110101011111111110101122112221221220102212021022200211001110011100a101011111101111101111111101111111111111
1011111100111101101111111101101111111a10a1111111111111100111101111011101111112112211121212112222112021001021101111111110a111111110100111110101111001111101111111
1011111100110110111011101111111110011a11a1011111111100111110111111111111111101001211101022221211122021211210100011101101a101110011111011111111110111111111011011
1111110110101111111111011111111111011a01a1111011111110101111101101111110000101112121000020111022221101100121111111101110a111110111101111111011111110111111011110
1100111101110011111111011111001111001a11a1111111101111110101110111111111011110021210200222220121010212021200111101011111a111001011011111111111011111111111110101
1111110111111111101011100011001111110a11a0110111101101111010111111110110100122102120020210211211211201101210111101111101a011110101110100111011111111111111011111
1110111110110010110111100011101111111a11a1010111111111101011111011111111011100011112021102202222202122111120111101101111a111000111111111101111110111111111011111
1110011001101100111111101101100111101a10a1111111111110101111111101111111110122122012112220021101112212112121101111111111a110011011111111111101111111111111011111
1111111110110110001111111101111101111a10a1101111110111111100111111111010110011111101202020211121000110201211111111111110a110111111111011111111111110111101111111
0011111111111111111110001001111211121b12a1110111102000120011111111111110111112112221121110111211101212222201111111110100a111011101101011111111010111111110010111
1111100111111001111111111222202211001a22b2122211112121121111011111110111111111112221121012201221122210221110111100111101a111111111111111110111010011111111110011
0110111111111001111011101120010202112a11b2112001122221011110111111111111111021121112121102201222212202000110110111110001a111111111000110110011111101111111111110
1111010220211002212201112022022202111a11a2111210120221121111110011110101111111112111211211012212212202222111000111111110a110111111101111111111111111111111110111
1110110111111110111101201010221122111b20b2122011122011121111111111111110111101110211212111212221122210111221011101111101a111110110011111111111111110111011101111
1111210211011212120211121221100021121a11a1122011011221011111101110111011101120122120210202212112121222121111101111010111a111111110111011111011111111011110011111
1011220111111120121212222110111111111a11b1111011111100011111100111111111111110010111111111111101111110011111111111101111a110111111111111111111111111110110101011
0101211102021120200012120112010210120b21a1020201112001011011111101101111000120122022121111221210011222022111111011111111a100101101111011011111111010111110110111
0111010111010110100001111111111111101a11a0212211110211100110111111111011111122021112122121120001211012220111111101011100a101111111000111011111111101111111011001
1111201012220202110002112121221112102a01a1221111111011121111111001111111111121121022211121211000011202221110111111111111a011110110110110110111110111110111111111
1101211011122212222212211122102122112a12a2122011111112121111111111011111100101012212100121102222112201222121111101111110a011011001111111110111111111111011011111
1110210122120212211112211122001112111b21a2211211112102111111100111111111011100122201010200012111212122001101111111000011a101111111101101111011111011111111100101
1111221222011111021100222121102120001a22a2112211012211101111111110110101110111011220102121021201111021120220110011110001a011101111111111111101111001111101101111
1010222012221202021201012020212210112b02a1112011112211111111110111111011111020111120022220222121201212101121100011011111a111111111111111111101111111111111111011
1111011110110111110011111101111011111a11b1202211001010110111111101011111111122112221111021221210112212022210111101101111a111111101110111011111110010111110111111
1111101120111212122201022111222211111a22a0101211012121110111111111011111110101122011122121110012211001220211101010111111a000110111111100111110101111111111111011
1101011111110111101101112120101212112b21a2222001112020111111111111111111100110101212112111201101221111121121011011011011a110111111111011111111110111110111000111
1111110111111111100112202122111102111a12b2122211102222111110101111111010110110111111011111110111011111111111111111111111a011111111110111111111111111111111111101
1101111110111111111102221022110110012b01a0122111112022021111111101111111111111100111111110111011111100111110110011111011a111110111111100111111111011000010111111
1001101111111111111101111111100011111a11a1211201112122111111110101110011111111111111111110111111100010110111111111101110a110111111110011011110110111100111101111
0110022212220012110210200111011201121a21a1212110111221111011110111111111011111011111111101111111111111101111111110111110a110010011101111111111111011101111011001
aaaaabbbabababababbba1222011021220110b10a1222111011011111011110101110111111110111101111101111011011111111111111111111111a110111110110111111101111111111001111101
10110012212000222221a2222110112120112a02b1211110111012121111111010111110111011111000110111100101111111101101111100110110a111101011111111111111010110011011101010
11001122101221022110a1111111011011010a11a1101211112201111111011111101010111111101111011111110111110110111110110001111100a111101111101111111111011101111110111111
11110112102222221202a1021022211120112a22b1002011111010121110111111100010101111101100111011010111111101111111101110101111a101111111011110111111111111111111111111
11112212121222122022a1121101221002102b12b0110011110022101011111101110111110110111001010011111011111110111111111111111111a011110111111010101111011100111011111111
10112212121220221202a1101111111101110a10a0111110111111111111111111110111001111011111111101110111111111111110111111111111aaaaaaaaaaaaaaaaaaaaaaaaaaaaaaaaaaaaaaaa
11112012021002112121a1212111111221022a20a12020101111111111011101111010111111111111111000111111111110110111111101111111111111110011111111010101111111101110110110
11111111011221000101a0221111012210110a20a22212111111201111110111011111111011110111111111100110111111111111110110001111110111111111101110111001111111111111011011
01100101210220100222a1222111112022112a20b20100110111211101101111111111111111111aaaaaaaaaaaaaaaaaaaaaaaaaaaaaaaaaaaaaaaaaaaaaaaaaaaaaaaaaaaaaaaaaaaaaaaaaaaaaaaaa
01101221121210222222a0122001011112112a21a11011010111111111101101111111111111111a11111111010110011110010111111011111111111111111011111111110111111111111011111110
01112212012221111221a2111011212222111a11a10111111011111110010001111101110111101a01111111111011111111111010111011111111111111101110101011111110111111111111111111
11111110211012111112a1122120101111111a01a11101110111111101111111111111011111111a01111011011101110101111101111010001010111111111111110111111101110111011010111111
11112221101022101222a1111101110100111a11a11111111111110111111111111111011111111a11111111110111111111111111101111011111111111111111111111111110111101011111111001
10111110011011111010a1111110111111110a11a11110111111001111111011111111011110011a11111101001111111111110111011011111111110011111001111111111110111111011111101011
11110111111101101111a1111001001010011a11a11011110111110010111100111110111111111a00001101111111111110111111101011111011111111111111101111011111111110111111111011
01111111111111101111a1111111111111111a11a10111111111110111111011110100101011111a11111110111111101111111111110111011111111101111111111011111111111111101111111110
11111100111001110111a0000101111110110a11a10101111011001111111011010111111100010a11101101001011110111101111011100111111101110100100011111111011111101110111111111
11111111010110111110a1111011111011111a22a22002101101211111120222201221110111011a01011111111001011111110100111111110010100111110111111111111111110101111110111110
11111101111110100111a0101011011111110a12b22122110110111020210211120201001111111a11111111111111111111111111111101111111101011111011111111111001111101111111110101
11101110001111111101a0011101110101110a22a01101011111211120102210012111111110010a11110111101111111110111101111011111111101111101111111111101111111111110110111110
10100101110011101111a1110011000101111a21a11101111111211121221221122221011011111a11101111101110110101111111111001110011011111110011101111111111110110111010111111
11111110110111110110a1111111011111111a12a11221111111101000012212122120111111111a11010111111011101001011111101100111011111111111111111110011110100111020212222212
11011111111100111110a1111111111111101a11a20111111111211100020202101011111110011a11111111010110111010011111011111110111011111111011111101111101111111121102212120
10110101101011111111a1110111111111010a22a10112111111211101221122212111111100110a11111111111111110111111111111011111110011001110100111111100000111110122112220211
11110110111101101111a1110110100101011a01b21111011101110111221222210121011011111a11011110101110111101100111111000110111111101111111110111111110111111222202011122
01110110100111010100a1220111110122111a12a11111111111010110111011111111111111111a11101111011111101011011111111111101111111011111101111110111101111111212121122221
01101111111111111110a1121101211111110a22a11101111111001111112121121111111100110a11110001111011111011110101011111011111010111111101110111111100111111111111111111
10111111111111111111a0020101212210110a12b21112011011110021112000121101110111010a10110111111101111111111100011011011111111111111110111101111101111111011221121222
00110110111101111111a1122101211011101a11a21212111121111121102111111111110011101aaaaaaaaaaaaaaaaaaaaaaaaaaaaaaaaaaaaaaaaaaaaaaaaaaaaaaaaaaaaa11110111210212221122
11101111111111101111a1121011202122121a22a01021111121111111111111121211011111100110111110111111110011111111111011110001011011111111111011111a11011100112101222222
10111011111111011111a1100111110101111a11b22112111110001111100111121211111101111011111010111101111111111111111110000111111111111111111111111a11111101201202022212
11111110111110101111a1211120211012120a22b21121011111111121110111111011111011111011101111110111011011111111111111111110111110011111111111001a11111111212110122012
11011101101111110011a1111111110212120a01b12221111121101121112120001211110111111111001111111111110111111111111001111111111110111111100111111a11111111100212211222
11101111111101011111a1220111100020122a11a12101101111101121102021110011110111111111111101111100111100111101111101111110101111110110111111111a11111111120112011021
11111111011111011111a1022101012221112a11a11012000121111011102011121111111111111111011111111110111101111111101110111111111111111111111111011a11111111212112122011
00111010011111111111a0211121111121110a02b02011111110111120112021011101111111111111110011111011111111111011111111111110011111111101111101111a01011101122212122122
11101111111111011111a1102120112022101a21b12221110120111111011101001211010111111111111111101111011111110110011011111111101111101111110001111a10110110112221120122
11100111111111111111a0221121102121101a11a11020111100111111111011111010100111010111011001111100111111111011101101111111111011111111111111110a11111101112112210011
11111100111100111111a1002121110222102a21b11110111110011121112101111111011010110110111111111011011111010111111110111111101111110101101111110a11101101211012111221
11111110110110111010a1202121011122110a11a11222100111111121011111021211110101011111111101111111101101110011110101011111111111111111111110111a11110011120211011021
10101111111111111101a1112121112212112a10b11220111111110120112111010110110100111101111011111111111011111011011011111101111101101011111101111a11111111210212212012
11101111101111100110a1021111210200122a01b21211101101100111112000121211011111101011111111101101101111110110111111111001110111111111111111111a10111110011120002122
11111111001111111111a0111121011102121a21a22202011111111121002121111111111111111111111110111111111111111111110011101111101111111110011111110a10001100222012121120
01111111110111111111a1121111102100122a11a00210111100111121110101121111111110101011111111011011111111111111111011011110110111111111111101110a10111111120020212211
10111100011111100011a1221121211221010a21b20121101110111101011121111111111111111111111011111111011111101111111111110111010110111111110111011a11111111120121100021
11111011110011111111a1111111101011111a11a10111111110110111111001010111111111111111011111111111100111111011100111111111111110111111101111011a01000110021222000210
10111111111111111101a1110111101111111a10b11120111111121111111001111011111110101111101111101111111011101111001101100110111111111011101111111a10110010211121112121
01111110011100111011a0112111212122102a11b11201101111121001111110110110111111111011111011111111101111111110001001111101110111111111101111111a10011111101211111201
00111111101111111111a1110111101111122a21b11111111111101111101111111110111111111111101110010111111011111111111111111100001111111001011101011aaaaaaaaabbbbbaababba
11111111111111110001a1111111111101111a11b11211111101110110111101111111111111111011111111111111101110101111111111011111100101111011111111111111111110112111101211
11110111111110011111a0111101111111011a11b11021011101101110101110111001110110101111111010111111111110101101111110101011011101111111111101111001111011110101100111
11100101110111111111a1112001002112112a10a11001111001111111111111111111111011111111101111111111111011111111111110111111111110111111111101110111110101111120121110
11111011110111101011a1120111212111022a21b10001111001101111010111110101111111111111111111110011111111111111001111011011111011111111011111011110111111111111111011
11110011111100011001a0122111112111120a21a11211111111001110100101101011111110101111111111011110011111111011011100101111111101111101111111111111011000111111111111
11111010011101111111a1011101111100111a11b11221011011011010001101101011011111111111111001111101101111101111111111011110111011110111111111111111111111111101111111
11101111111111010110a2121111200212121a21a11120111011110111011110101100101011110101111111111111101001111111111111110110100101111001011111111101111111111111110010
11111111111111111012a2111111112122121a21a11121111111111011111111111111010001111111101111110111111110111111111011101101111111110111011111101111101111100111100111
11011111111111011102a0112011212020121a21b11121111101111111111111111111110111011111111111111101101111111111111111100111111101100111110101111111110111101111111110
01110111111111110110a1011101111110121a11a11211000101111100110101111111100111001111111110111111101000111011111111111101101101111111101111111111111100110111011100
11001011111011111111a1122001110010111a11b11220111111110110111111101111101111111111111111111111111011011111111011010100101111111011101101111101111101011011111011
aaaaaaaaaaaaaaaaaaaaa1110111111101111a11a11221111111111111111111111011111111111111111111111100001111111111110111111111101101111111111100011010111111111001111110
1110111111111011111112010101112210112a11b10011110111111110101111011111111101101100111111110101111101011111110000111101111110101100011111011011101111111111111111
1110111011101100111112110111101212112a21b11121111011000111111110111111111101111111101111111111010101011111111111111101110101011111111111111100010111101011110111
1010111101110100111112102101112122122a11a11201111101111101022111111101111111111111012111211111011111101111111111111011111110111111111111010101111001111111110111
1011110111100111001110112111201121121a11b10121111101111111111111111010111011110111112011211011111111010110111111111111111110111111111111011111111011111111011111
0111111111011111010111111111112012100a21a11201111011110011111110110010110121111211112111211111001111111011111101110011111111111101111111110101101111111111111111
