116 59
18 27
56 71
50 153
48 138
118 115
48 27
111 97
37 114
49 11
10111110111111111001011001110111111111100111011a1111111111110111111110111111110111111110111111111111100110111011111111101101111111111011111a11010101000111011011
10111101111011011101111101110000111111101101111a0111110101111111111011111101101111111111111110100001111010111101110011111111111101011111011a11011111111111111111
11111101111101010111110111111111110111111111111a1111101110111111101111110011111111111111101111111111100111111101111101111110101110111111111a11101111000110111101
01111111111011101011011101110111011111101101011a1111111111111111011101111111101011110011111111111111011011101111111101011101111111111111101a11011111111111011111
11011111101101111110111110110101111011111111010a1111111100111111111011111011111110110011111101111110111010011101100101111001001111111110111a11111101111011111111
11111011011010011111111110111111011111011111111a1111011100111011110111111101111011010011111110110101111011111010101111101110101111110111010a10101101101111111110
11101111111111101111111111101011001111011111111a1111111111011111111101111101110111111111110111110101111111011111111111100111011110111111011a11111111111001111111
11111110101101110110101011111001111101111111111a0111111110111111110011110111111111111111111110101110011001100111111011010111111111111111110a11111111011111011111
aaaaaaaaaaaaaaaaaaaaaaaaaaaaaaaaaaaaaaaaa110111a1101100111011111111100110111111110011111111100111011011110111111110111110011001111111111111a11110111011110111101
1111110111101011011111111111111011111011a111111a1111011111010000111111111011110101110111111111101111011111111101111101111110111111010110111a11010010110111101111
1111101111001101011011111111111111111111a110110a1101110100101010111111100111101111101111110011110111111101111110001101011011111111111111111a01110011111011111111
1011101001111111010111111111111110111110a111111a11010111110aaaaaaaaaaaaaaaaaaaaaaaaaaaaaaaaaaaaaaaaaaaaaaaaaaaaaaaaaaaaaaaaaaaaaaaaaaaaaaaaa11111110111111111111
0111010011111110101011001111110011111101a110111a11111111011a1111110101101111111110111111101011111111111111111111111111111011111111111111110111101010011010111110
0011111110011011111101111111111101110101a111111a11111111110a1111111101011011111011111111110101111111111111110001010100111110101111111111101110111111111110111111
1111111111101111111111110111110101111110a110111a10111111110a1110111101110111101111111110001110001111101110111100011110111101111111111010011111111111111111101011
1101111011111110111111111111101101111011a111111a01110111111a1101110011110011111010110111111111011010101111011101111011111101111110011111111011111111111111111111
1111111111111110111011111110110101110111a001111a11111111111a1010111011011110101011111111111100111101101111111101111100111110111001111111011101101111110011111111
1111111110111111111111111111111011100111a111101a11100110111a0111011110101111111011110010111110110000011111111111111001101111111111110111110111111110101111001011
1110010111111111111111100111111011111011a111010a11001111111a1111110101101111110111110111101011111011111111111011111111110101111010001111010011110011111111111101
0111011110111011011111011011111110110101a111111a11011011111a1111011111011111110111111111111110111111110111010111111111111111011011011011111101011111110101111010
1111110101111111111111111111111111011101a111101a11111111011a0100101110011111111111111011111111111011110101111111111111111111111110011011111111111111111111101111
1111110011111111011111011111111010111111a101111a01111111111a1101111111111111111110111110111111111001111111111111111011011110010111111111111111011001011011111110
1111111111111111010111111001111111011111a110011a10110111111a1111010111111110011111101111101111111111111111111011010111111111111110100011111110111111111111110111
1110111110111110011011011011101110110111a011111a00011111111a0111011111111111110011111100111101111111011101111111101011111011101011111111000011111110011110111111
1101001010111000111111111110100110011111a101011a11111101101a1011010011011111111111110111010111101111011110001101110110111111110110111110111111111011110111111111
1101101110110101110110111111011111110110a111111a00111111111a1100001110101011111111111011011101111011111111111111011111101111101111100111111111111001100111101111
1111111111111011100111011110111110111111a110111a01111111100a1111111011101111110001011111111110011111111111101110011111111111111110011111011111111111111111111111
1111111010101111000111110011111101110111a011110a10111111111a1111010110101111111001111110111111101111111001111111101101111010111111110011101111010111011111001111
aaaaaaaaaaaaaaaaaaaaaaaaaaaaaaaaaaaaaaaaa101111a10101111111a1010100110110101111011111111011111111111111111010111111111011100001111110111111111110110011111011111
01111011011100110111110101111011111111111101110a10111111111a1111111111111111111111111110111111111111111011111100111111110110111111111111111101110111110101111101
01111111111011111100111111000111011110111100011a01111101110a1011001111101111101110111111111111111111111011011111111101111111111111110111110111111110111111111111
11111111111101111011101110011111111111111111111a11110110111a0111111111101010111111111011011111111111111110110111111111111111111111111111101111111011111111111111
aaaaaaaaaaaaaaaaaaaaaaaaaaaaaaaaaaaaaaaaa111111a11111111101a1111111111111011011011101111111111101010010111001011110111111011101111011011101101110111110111101101
1111011101101011110010111111011101111111a111111a11110011111a0111111110111011111111101011111111111111110111111110111011111010011100101111111011111110111111111111
1101101111001111111101111111110100111111a111111a11111110011a1101101110101110110001111111111101100101101111011111111111101011111111111111101110111111001101110111
1111111111111111111001111010111010111011a111111a00110111110a1111111110111111111111111111111111111101111111101110111111011111111011110110100101011011111111111110
1111111111110111111111111011111001100101a111101a10111011011a1011111100110111111111011110111101101111010111111111111110111111111011111011111111111111111110111111
0111111111111111101101101101011101111101a111111a11101111110a1011101111111111100011111111111111111111110011101111112111212211020022101112111221001110110111111111
1111111111101101011100111111110111010111a110111a11111111111a1111101111110111111110111111110011111101101111111001111120110110120211222102102211222111111111011111
1111010101111111101111110111111111101111a101111a11111111100a1111111111011101111010001110111111011111111111111111111021201122112021112022122111221001111111111010
1000111101000111111111110111111111111111a111111a10111111111a1110111111111011111111100111111111111111111011111001111121212122222120120200101022101111110111110011
0111101110111101111111110111111111111111a001110a11101011111a1010111011111101110111111010111101111111111011011101112221112220212112222222222221222111101010111111
1111111111111111111111111100111011111011a100011a01111111101a1111110011101011111111101110110111110111111111011111000222122211221212201012201111021111100111111001
0111111010100101011111110100101011111111a111111a11110111111a1111111111111110111111111111111110111101111011111101112021222121210102222222212010012110111111101111
0110111111011011111111110111111111010111a110111a11011011110a0010111111111011111001110111011111100011111011111111111101220101021122221202101111011101111111111001
1111111111011110011010110111111111111001a111111a01111110111a1111011111011111111111111110010111111110101111101111110120001112022022001112210212012111111111111110
1101111101111111111111101111111110111111a011111a11111110111a1111101110110110111110111011111111101111101111111110111012021012211220112010201122211111111101111110
1111110101111111111101111011111111111011a011111a10111001111a1110111110001111111111011100011111111111110111101011111002220120222212200202020202221011111111111111
1111010101111111111111111110120222111112b222121a20112110201a1111111111111010111100111111111101011111111101111011112112021221012122120221121221111201122022112110
1011110001112121121200111101121201211110a102111a10222122111a1111111111111111111011111111101011101110100011111111102200112222221212121112121222112212000211210221
1111111111110111101111111111101111111101a201110b12111221211a1001111111110101111101111111101111101100011101011011110111202110212222111220121222012221112222021202
0110011111002022012122121112201122211122a111221b21112211121aaaaaaaaaaaaaaaaaaaaaaaaaaaaaaaaaaaaaaaaaaaaaaaaaaaaaaababbababbbbabbaababbaaabbabaabbabbbaaabbbaaaab
aaaaaaaaaaaaabbababbbbbabaaaaababbabbbaab111110a0112011112110111111111111110111111111101101101111111011111111110112120021202111121220001001220021022221011220111
11111110111021211121121100222221021201221200100b1122112220101100101011111010111011011011111111111111110011001111112121012200212211111121111210221012221221112112
11111111111111111110112222111112021111222001111a1120201121111111111111011010101111111111111100100101101110101111110210212221212212111202222211222221111110120022
01101111011212211220112120112122122211111120111a2221112111011011111111111111111011111111111111011111111111111110111120202120212221222210211011211222121120020111
11111101111111122121112011102022222222112012111a2122111020110101010111122012022200211220122211221012021111111001112011022121022211221112121102211111221211122110
11011101101111122111102211021220211120121211112a1111210021111001111011112112111222111211100110121011221110001011112001221121011201221122202112121211210211221122
10111111110112111222120112022112012221221101012b2220002221111011101111122021120102010020212012112200111111011111001110111200022221112202121111220111102221112212
111111110112211120110220102babababbbbaaaababbbbb1212202102110111101101122121210221112002022221110121021010011110012221110100221211120121112022112222221222111122
110101111101022101221111011b222220122202101120102122122021110111111111112112222012121220222011120121221111010110110011222112012202211220221120022001122102201221
111101111101210201211102222b000122022101112010121112112121111111111111111112222212202000211001210100220111111100111111021101222222211010210111111122212110020211
111001110101112101121122101a122221221122221211121001102211111011110010122201212212220211120110220012120011011111010200211102221120222221112202212222201221122200
111010110112120120221221012b220222011021211211121222212221111101111110121011220211022110121120121122121011110010101002111110222021211211221211120122212221200121
111100011101111111110110111b222012112101121012201111122121111110011111100212122020221021200112111100221100101101112202012011010012211122221201022200111121100111
001111111111222212121121201a221212012110122111211011111122111111011111111210112211222221111112022211211111011101002022221221210112211221212120112121210221120112
101111111111111110111101221b121221122202112211201022210211111111010110122201101111221221211212220122121101001111110211120121012200111221211112202111220212222211
111101111011111111111111111a012122201220110110211222122222111111111111122102111200122011221121202221111110111001111221222221211212211000121222121201122012222212
111101110010111111101011111a112212020111210121211221222110101111011111112220112110211112122112221221021011111111111111111111011010101111111201121221222120110022
110111111112120001211021200b021202121220210012102122211011111111110011110012110012122122201110011120021111000110001101010111111111111111011212211212120221212101
000111111012022212110212110a201122112122221101112111002021111101101110112110212122112221001221210210210111110111011110111111110110111111112112110201021110100202
111111111111121102201201110a221112220222211112121002111011111111111011000221122001210111122222222212210011100011101111111111111111111111110011202121202210122211
110101001111011111011111110a122011101001212102221112222111011111110111112111102022112111020110001222221110111111110101111110111111011111112101122122211211110210
111111101011111101111111011a122212211212201011021021212012011111110111112020102222222111202020220110121011111101111010111111011011110101111000121100021111022220
111100111111111101111221122a121001211222110120212120121222111111010011120212011122221202221221111222111111011111111001100111111111110110011112022201120111122020
011011111102220011201121212b002111111211122210212101222111111111101011121121211111110201222201211112121111111111101111010101111111111111112110001111101122002121
010011111111101012001211110b212210120011112222210112022221111011111011021212122212110020120212011212111001111111111111111101111110100111110111101200022102201110
111101111111122112101211011b000122110212212220211221201112110010001111122212112112221111212011220122221111111111101111001111111110110111112011211102122221201202
111101111112221121100202112b121122112202002102210222112111111111110111010211111110110112202221012222121101100011101101111111011111111010112212212011011221111012
111110101112212111200121012a210222112110111111111111110111111101111111111121211021011110222202122001011101011111101111111110111101111111111111101111110111111110
011111111011111110101111110a111101111111000110111100111111111111011101101011111110001111011111111111011111011111111011111110001111111101011111111111111111111111
111010111001111111111111111a110011110101111111011111110111100111011111002101222022011201120210222220020111111111111101111101111110101011101100110111111111111111
110110111111011110111111111a111010111101010110111111111111111111111111111211120012121201222110210222111101001110111111110101111111111011111011111111111111111101
111111111111111001111110111a111110110101101111111101101011101110111111122021112212222100121101022122111111101111110110111010111011111111111100111100111101111101
111111101011111111111111011a111100011011111011111111101011011110111101011121120220220011222212102012001111110011111011011111111111100111111010111110011101111111
111111111110111111111101010a111001101001111111111111111111110110111111111221002222112211112210122222201111111011110111101011111111111100111011111111111111101111
111111101110111111110101111a111111000001111111011111111111111111111111121022122112112212102111012220120111011111111111111110100110110111111011111100011111111111
110111110111111110010111101a111110111111111110111111111111111111110101011111111011110111111111011110111111111111011111111111010011111111011101111110111110110111
111101111010111111111010111a111111000111111011111101111111111011110110111111111111010101111010111111101011011110101111111111111111011101110000110111111111011011
111111111111011011111111011a111110101110101111111101101110110010010111111110100011111110100111101111101111101101111111110101110111111001111111111110011111110111
011011000110101111111110111a111010111111111111111111111010101111101010111100111110111111111111111111111111110101110000111111111111111100011111110111111111111111
111111101111111111111111111a101111111111111111111111101111111111111111111111011111111111011111111110111111011111011011111111011111111111011111111111001111011111
111110101111101111111100101a011111111011111011111111111100111111101111011011111100001011111111111111111111111111101111111110111111111011111011101111111111111111
111101001111101101111111111a111110011110110011101111111011111111110111111111110110110111111101111010111111011110110010111111111101101011101111001011001101111101
011111111010011110101101111a101101100101101111101111111101101100111111111101111011111111111110111101111111111110111011111110010111111111111111011110011111111011
111101111111111111111101111a110111111111111101110111101101110111001110111111111111110111111111111111111111111111111111101100011111101111101100111111101111001101
111111011111001111111111111a101111011111111001011111101111011111111100101111111101111110111111111011101110111110111110111101110010111110111111110111111111111111
111111111100111111101011111a101110111111111111110111101101111111011111111111010111001011011110111111111111111111011111011110111110111101011111111111111111111111
110110111101011010001111111a111111101111111111111110111011101101111000111010101011110101011111110110001011011111110111111111010111101110111011111101111111111011
111011110111111110110100111a111101010111011111111111010011011011111111111111110111111011111111111111111110111110111110011111111111110011101111100111111111101011
101111111110111111110101101a101111111011101111110111111111111111111001111111111111111101111111101110111111111101111111001111111111111111111010111111101110111111
111110101110111111111111111a111011011111101110111111011110111111111111110111101111101011111011111111111100110100111001011100111111111111111111111011111111111101
110111111111010110111111011a010111110111101111011111100111011111111011111011101111001011011111111111111111011111111011111111101011011111010110111111001111111111
001101011111111110101101011a111111011101101111111111101111111011111010111111110111111101101011111110111100111110001111011111110101011111111111101111110100011011
110011111111101111111100001a111111100011101011000010111111101101100111110011111111110111111110101110101111111111111110111111111111010011011111110111011101101111
110111111110111111011010110a111111111111111011110111101111111110011111111111011101111110111111101011101011111111111111110110111111111100111111111101101011110111
101111100011111111100011101a111101111111111111110101111101101110011111111111111110101111011111111111111111111011101000011111011011111111001111111111001101111011
001111111111111111101111110a011111101111101111010100111011111111110111101011100111101011111101011010111111101110111111111101011001110111111111100011111111110011
000011111011111111101101111a011111111111011111110011111111101011111110110111111111111110010011111110110111111111111010111101001111011110101011010000111011111111
111110101101101111111011111a111111101111111111110111111111111111100111011110111111110111011111111111101111111010011111111011111111011011111111101111011111111111
111101011011101011110111111a111100011111111101111010111100111101111111011111110111111110111111111011111111011101111110110111011011111111101011101111111101111111
001111010111110111111100111a011011011111011111101111011110111111111100111110111111111111111101101112021101121110211220112020111101111100111111111110101111111111
101111111011111111101000011a111111111000111111111111111111011111010011111111111111110110101010111011221210222020021211112020111210000111101111111110111011101011
110011111110111111111110010a111001111110011101001101011111111111111011111111111011111111101111110100211112200112012120222210220210101111111111111110111111111111
001111101111001111001110110a101111110111111111101101111111011111110010111011111011101111111101111112220111221202110100102222010211110110111111101110111111111111
011111011011111111111111111a111101111011111011001101110111011111111111110111010111011111111111001112112101212020211020211211221011111111101101110111111111011110
111111111111001111111111001a101011111111010101111001111100111011111111000101111101110011110111111212101012221122222221000111112001111111111001111111110111110111
101101011110111111110110111a111111111111011101111111111110111111111111111111111011111011111110101020220021210120121120010110121111011011111011111111101101011111
111111111101111111111011111a101111111111111111101101111111111011011101111100011111011111111111110110010112221021221112122111122210212111211202112211101011111011
111101111001001111001111101a001111011010111111111111111100111111111110111101111111001111110110110022212220222112010222121212101111022102110102002111111111011110
