7 32
100 78
111 147
118 62
59 38
105 96
30 83
26 103
93 134
97 8
1100111111000111111011111111111111110101111101111111111111111111110011111110111101111111011111010010101101011110011111011011101101011111110a10110111111110111111
1111111111110011011100110110111111101101010101111111110111101111111011111111110011111010111111110100111111011110110111111110110111111001011a11111110101001110101
1101011011111011111101111101111111111111111011111101110111111101011111111110111110101111111011111101101111111110111100111111101111110001101a11111111111011111011
1100111001101111111101110111011110101111111111111111111111010111110100111111011111111111011101111011110111101111010111111111111111111111111a11110110111111011011
1011111111011101111101111101101001011111111011101011111010111010111011101111011111111111111011101111011110110111101111101011111011111100111a11011010111011111111
1101111111111011011110101100001110111110110011011110001101111111110111111111111011111111001110111111111111111100111101111111001011101011110a01111011101111111111
1000011111111011111110111011111101111111011101111101001111111111111011111110100110111111111110111001111110011111111001111111110101111111111a11010011110100101111
1111101010111101101111111011100111101111111111101001101111110001011111011111111110110111111111111111111101110111011101111010111111111111111a11111111101101101111
1111111100101111111111111111111110101110110111111111101111101111111111111111111100110110011111110101111111111111010111100111111111111111101a11011111111110111111
1101111011111110101101000111111111110111111111111111111101111111111111110111111111111110011111111111111110010111111101111111111111111111111a01111101011111111011
1111011111111001011111110111111111111011111111101111101110101111011011111111111111111111111011111111111101011011100111111010101101101111111a11111111101111101111
1111001111111111101010100101111110101111011111111111101110111100110001111111111111101111110101111011111101111111011011011111010111111111111a11111111111111100111
1011100111111110101101111110110111111010110011110011011111111111111111111001111111111101111101111010111111111111111101111111111110111111101a01101111111111010110
1111111110111110111101111111011000111011111101001101111110111111110111111010111110101110111101110111101101010100111101011011011110111111101a10111111111101100110
0110111111001111011111110111111111111111001111101111111111100111111111111111111111011111111111011110101111111000111110110111111110111111111a10111010111010011111
0101011110111101101110110101111111111110110111111010111111011111101001111111111011111011110111111110011001111110111111101111110111111011111a11010111100111111110
1111111100110011001111010111110111111111111111111111111100011111111111010110111111111110011111111111111111101111111110111110111111011011101a01111101011111111111
0110001111111101111011100111111110111110111110001111111111010101101111101111010111011111111111110111111111111111111111111111110101011110111a11011011101011111111
1111111111101111111101101111111111111111110111111111111111111111111110111111111110101111111111101111110111011111111110111111111111111011111a11100110011111011100
1110111010111111011111111111111111011110111111111111111011011110011111111011101111100010110111101011111110011011111111101111111110111111111a11011111101111111111
1111101101111111011111110111111111110111101110111111110101010111101111111011111111111111111110110011111110111110111111111111111011011111111a11101111111111011110
1110111111101111101111011111111101111111111111101100011111111111110111110111111111111000111011101100111101111101111001111110111011011110111a11011101111110111111
1111111111111011010110111101011111111101111111111111101111110111111000011100111011111111111001111111111111010111111011101101111111111011011a11111101111011111111
0011111101111111111101101111100111111111101111111111111111011111111111100101100111111111111111111111111111111111101111111101111111111110110a01111011111110100101
1111011111011111010111111111111101111111111101111111001111101011111111011111111111011111111111101111011101111111111111111111101011111111101a11101001111001110101
1000110111011111111111111111111111111111111110010111111111111110111111111111111111111111111101101111111111110110001111111111110011011011111a00111111111101101110
1111101111110101110111111110110011101111011101101101111111111111101111100111001111101111111111111001011101111211202112112112021122122111111a11111101111111110111
1110101101111111111111110100101110110111111101011111101111011011111011111011110011111111111101111111111202221212211120121221201200110211001a11111111110111110111
1111111101101111111111000111111111101110011111101110111111111111011001111011110011111110101111111111111101122202011021110221010222022011111a11001111111101101011
1110111111001101100010111101111111101111110111101111101100010111111111110111011011111111111111011101110112122201011211201011211011022201011a11111111101111111111
0101111110110111111101110101111111011111111111111001111111111010111011111111100001121212112111001222202111221101111211112112122201112201111a11111111111101011111
1111100111111111111111100101010101111110111011111111111110110011110111010101111111120121002212211220121222101022111221222200221000222001110a11110011111110111111
1111110111111110111111110101111110111111111111111111110110111111111110110111111111112122010211101122202220111100212222202110221202202111111a11111011011111101011
1111111110110011101111111011111111011010001111101111011110111111101110111111011111111222122100210222101211222122121102111100222112220011111a11111111010111111110
1101111101110111111011111011111110101111011110110110001111001111011111011111111111112102112222122120211210101022122022222202021112211111001a01101001111100111010
1110101111111101111010111111111101111111011111111101111110111011111111101111111111121120201011211222122101101022210101122120122211122011011a11101111010110101111
0111110111111110111101111111111100111111110101111111111111110001011111001101111111122022100122002021111121122222122122111120221221112011111a11111111111111100011
1111111111111111111110011111111101110111101111111111111111101011111011101011111101120222110222210101021112122110121121200102010212022111011a11111110111110111111
1011101100011111110111111001111101111001011100011111111101101100111110111011111101102221211112222212121101221010111212012022022210100110111a01110110101101111111
0011011111101111101111110110101110011101110101100011001011111100011111011110111111111222021020011221120022120210201000211122022010202011110a10111001111111111011
1011011111011101111111111101011111111001111111111101111111111110111110111111111101110202112202212120111202212110112221122220220101022101111a11001111001101100111
1111111111111111110011110111111111010011101111110111111111011111101111111111011110111111111010011111102121111221001012110012221011222211110a11111101101111111011
0111111110111111010010011111111010111110011111100111110110110111011010111111111111102112112022222220112222100022122212121211021111122110101a11011111111101011110
1111111111111001111111101111001111111111111010001111111110111110110111111111111111121121212121021220102001112122122120211022011111112211111a11111111110111011011
1100111111101001001011101010011110101111101111111010111101111111110111111011111111101220022201212102122221022121222021200201100222212110101a10111110011101111111
1111010111010111101111011111111111111001111001100110110111100111111111011111111111121101110111212222112222110202111110102222210221120101101a11111110111111111010
0101100111111111111011010111111001010111111111111111111011001011111111110010001110121221021212202210112122211022220212212121212222221111111a11111111011111111010
1111111111111111110110111101101111011110111110010111111111011011111111011010011111111102101202102221010101112010222011202222112122221101101a10110111111111111101
aaaaaaaaaaaaaaaaaaaaaaaaaaaaaaaaaaaaaaaaa11111111101111111111000101011111111110100022121220212111001120112111102222121212220122220121211111a11010111111111111011
1101010111111111111111111111011110011111a01111111111100100111101110110111001111111020122221110221112100111222112112112101211121212120110011a10011011111111111011
1110101110111111101110111111111111111111a11111111101111111111110010111010011101110100002222222010101021101201012222202111012022122110111111a11111111111001110100
1111111111011100111111110111011111011011a11111101110111110111100101110101111110110011102120220122211111222220201012210220122212220122100101a11111110111111011111
0111111111111011111111110111111111101111a11111110111101111001111111110111110111011122222112222221022112201012102021211111221021110120010001a10111000111001101111
1010111011111101111110111111101111011110a01010111111111111011100111111111110011111111111111021201122111101201111120122120200211120101211110a11111111111111011111
1111111111110101100111111010110001011101a11111110011111111110111111011110100011111101122111012222222111110212112222122100110101101111111111a01111101111111001011
1111111111111011101111111111111101101101a11101111100111111110011110110111101111110111112211100122111012120122122100122112012122221221111111a11101111011011110111
1111111101011110110111101111111111111111a10110111111111111100011111110011101001111102020010112022211121022111102222202212212111102222111110a11101111111111111111
1111101111011101111110101111101101111111a10110111110101111111110111111111011111011111102221012201212010021021122120111101111010101111111011a00111111110111111111
1111010010110101111111111010111111111101a01110111111011000010011110110011111011011121112222212111111121121110112121111101111111110111101111a11101111101111111111
1101011111110101111111111110011010111122b21211120211201021110201201211111111111100112012020121212001102021201112110111111111101011110111110a10111111110111111110
1011101110111111111111111111111110111111a12121112210122220111212101211111110111101111022211110212202021221212110011111110111100110101111111a11111111111111111111
1111001111111110101101101111111011110120a20222111210222110210121121211111111111111111111101111111111111111100011110111111111110111111111111a11111111101111111111
1111111111111111100001111011101111011111b10022122021021100221220001010111110111111111011111110111111110011111111111111111100111001011111101a10111111111111111011
1111110111110110111111111110111101111100b00011010120111121121100100011110111111001111111111011110111111111111111111111111011111111111111111a11110111111011101101
1111111111010111111001011111111111111111a20121112201122021111111112121111111101111111111111110111111110111110011111110111111001101110101111a10101111111111111011
1111111110110111101111111111111000111011a11111111100111101101002212221101011111111011111111111111111111101110111011110011111101101111111111a11111011111111101101
0111111101101111111011101111101011101111a22000221210021201101121122110111011111111111010111111110101011101111010111111111101101011101110101a01111101011111111011
1101100111111111111011100111111111111121b11112221201221022021210011211011111111111110111111110110111111011101110111111011111111111111110111a11011111000111111111
aaaaaaaaaaaaaaaaaaaaaaaaaaaaaaaaaaaaaabbb12211112202121112122211212221011110111111111111111111111111011101111111111111111110111111111001111a11111101111011110111
1111101101010111111101110111111111111111112122222111100210222111211021111111101100111111110101111111101111111111011111010110101111111011111a11011110100111110101
1110011111111000111111111111110111111101012222121202221212012221102220011111111101111111111101111101111111101011111111111111111111111111111a11101111011101110111
aaaaaaaaaaaaaaaaaaaaaaaaaaaaaaaaaaaaaaabaaaaaaababaabaaaaabababababaaaaaaaaaaaaaa1111101111111101111111111111111111111111111111110110110111a11111111110111111010
11111110111101111111011111111111011100021102100222012210102211020212200110010110a1101111111111101110101111101011101111011111101101111101101a11011111011011111111
10110111111111111011011111101111000111011021110122101012201202212221211101111111a0111110111011111111111111001111011111111101111111100101111a11011110111101111011
aaaaaaaaaaaaaaaaaaaaaaaaaaaaaaaaaaaaaaaab111121211222021102022121102111110011111a1111110011011111001110111110111100101111111111111101111110a11011111111111111000
1111111111101010111111111010101011101120b221111111122121111122202122211111011110a1011011011010001110111111111111010111111111011111111101111a01111011011111011111
1011011111111111011011111110110111110010a121121221012101101111221010011111111111a1101011001111111111001101111110100011011111111110010111110a11101111010101111111
1111111101111111111111011100001111111112a021211111122112112210102021211111111111a0111101011111111111011011111111111111111110101111111101010a11111001110101111111
1111011111011111111111110111110111111111b001122112102102201022112020011110110111a1111110111001111111111101110111101111111011001111101110111a11101111101111110011
1110011111111111011111001111011111011021b210112011111101202211022211211111100110a0011111011111111111111111111010111011111111110110111111111a10111111111110001110
1101111011001111101111110011111111111112b201220222110211111110211222010111011111a1111111111111111111101111101111111011111111111111011111001a11111111101111111111
1111111111111011111111111111110100110122b200200102122011210202112012200111110010a1110111111101001111111110011111111111011101111111111111001a11011111100111001111
1111011111111101001111111111111110111011a121221222221121222220221101010111111111a1111111011011111110111111010011011101111101111110111111111a11111101111111111111
1011111010111101111111101111011101111022b222212220221211001022200210211011111111a1011111101101111010110111100101111011111111111100111111101a11111101101111100101
1111110111111111010111111111111111111121a201211021012212011202021121211001111111a0100111100111111111111011011101111111111110101111111011111a10111111111111111011
1111111100111111001111111111101001111111b110011210111201021221120111211101111111a1101111111111111111111111100101101011111111110111010111111a11111111111111111111
0111111111111111111011110110111111101011b120201121220021021111120221111011111111a1111111111111111101011110101011110011111101111111111010111a11111110111111110011
1111111011111111111111111101001110111111a110212212101112121120021211210111011111a0111111111111111110111111111111010111101110111111111101110a11111111111111101001
1111111111111110111111101111111111111122a122222211220210222022111110211111111110a0111101111101111111111110111111011011111100110111111101000a00001111111110111111
0010111101111111011101111100110111110121b221111212111021212221222222000110111110a0101110001011111110111011011111111111111111111111011011111a11101111111110110111
1111101111111001111011111101111110111111a110011111111011111111011111110111111111a1111111011111101111010110111110110011011111100111110011111a10011111010011101111
1111111101011111101101110101111111110111a111111111011111111111111101101111011111a1111111111111001111001011111111111111100000111100111111111a01111001110111001101
1111111101111111111111111110100101011111a101110111111011111111111111111101011110a1111111111101011111111111010110111101111011111100111101111a11111111111111011011
1111111111111100111011111111111111010110a110111111111111111101011011111111010011a1011110101110010111011111011111111101110101101110101012121a11222102111100112001
1110101111101111011111110111101111101110a111101110111010110011110011101110100110a0111111101111111011010101111111110101111111111011111100010b20112112222221112211
1010110111111111110011110111101010101111a011101111110011111011110111111111111111a1111110111110011110010111101100110011111111111110111101120b01211112221110012101
1111011001111111100111100011111101111111a011101001111001111111111111011111111111a1010111110110110110011111101111011101110100111101111101111a21001112221222121000
1111111111111111111111111101111111111111a110011001000011101100111111111001011111a1010111101111100010111011111010011100111010100110111120212a02021221100212210212
1101010121121021021022212021122212122011a111110110110110011111110011111111111110a0111111101111111111111011011111111011010111111110111011010b12122011110121110122
0111101111110111111101111001100111011111a100111111011111011111011111111111011111a1111111011111011111001111111111111101101111111110111010220b22100221212211222202
0101011021221112222022120222122212120121a101101110101111011001111110110111101111a1011111011110110111111111111110001111111110111111101110121a21111121222202210101
0010111101012110120221122221012112112211a111111110011011111011101111101101110110a1110110111101110111111110111110111011110111110111111111111b12010110011102112212
1111110102100021102212210121102210120101a101111101111111110111111111111111111101a0111111111110111101111111111111111011100011110111111121221a22102221002120110110
1111101111110110000011101111111111111111a011111001110110011111111101110101110111a1101111011111011111111111111101111111101101001011101001120aabaababaaaabbabbabba
1101110111110111011011212201111212111220a011101011111110111110101110011111110011a0111111110111100011110011111110111111111111010111110021112001201211112110210221
0111111122212212121210020201010022212011a111111111111110111011110011111111111011a1111111111110012122221122202012012021222221221011001010111122112111110102212012
1111111110221001211111221011112121122011a111000100100111001111011111110111001011a0110111111110112122012001012012111200111200112110111120221221102220002122122222
1011011111011111111112101120222122110121a111111011111101011111111011111011111111a1011101111110012110200012202121222211100221011111110101101222220202112210112221
1101111012000220201202121001211121121110a110111011011111111111111001111101101111a1101111111111112221112120001101022111212221122110111120111212221101021222221221
1110111112022110112102020120021022221011a111011111111100111110110111110101111110a1111010101110102121002110122111011120210121012110111102121222111002211111200122
0101111100022222211112020022202011012021a110001111100101111111001111111111001111a1111110111001102211212220222102101121102112222111011110121112111022122211220222
1111111011110111111110111111011111111011a100110111111110101111111011011101111101a1111110111110011210011122111022111221212121102111111120122122122111121211101002
1101010122022120212212101112210112222221a101101111110101011110111110110001110111a1101111111011010000110010222221221222222201011111111121110112110102200112112220
1111101101111101111101111101111011111011a111111111111101111111001110001111111111a1111010011011112211112020222122001021122212011111111112211221211212212211120122
aaaaaaaabbaabbbabababbbbbbbbaaabbaaaabaaa111011111111111111111111101110110111101a0011101110101101002122012220222121211211210211011111120121110222111212210012020
11111111212202012202112110110122222211001011111111111111101111111001111111111111a1111111100011111122212201122122102211022122112111001121112121011011121222001002
10111101110011100111111111101110111111101111111101111111101111100111011100111111a1011111111111111110112121211001122122211112212101111101222211011121112221000222
11111111111111111110111110111100101001111111111101101011111111001011010011011111a1111111111111101122112221122122111221211121110111111121011011212120112112112212
10111111111111101100111111101110111110011111111110111110111111111111111111011111a2112212222111112001121121220212212111222101112011101112210122202120222122210220
11110010111111111111122110211202211001111111101011111111111111122212012101211122a1222011121211110110121021221111002120111111110101111121111021212212220210002221
