86 142
114 3
61 118
63 25
79 85
41 46
69 133
87 115
67 99
60 92
1111001110011011111a10a11110111001111110101101011111001111111011111110100111111101111111110110100011011011101111111111011111111111111111010011110111001111101111
1011111111011011111a10a10111110111110111111111011001001111111111111111111110011101011011011111011011111001111111111111110101010111111110110111111111111111111111
1110101111111101111a11a11011100111110111011101001111111011111101110111111111101111111011110101110111010111111101111111111010111110111111111101110111101111111111
1110111111001011100a11a10111111111111110111110011111110110111111001111011110101111110111011011111011110001111111011011101110111111110111111111011111011111111011
1111111111111110111a11a11111111111101101110111111111110011111111100011111111011010111111111110011111010110011001111100111111111111111111011111110111111110111111
1100101111111011101a11a10111111111010110111111111111011111101001111111111101111011111111101111110101111010011111111111111011011101111111111011110111111011111111
1100111111111111110a01a11111111111101111101111111111101011101101111111111010111111110011111111111011111110111111001110100111111111011110011111000111100111110110
1111101110110111111a11a11111010010111011111111111111111111110111110111011011111101111011001110011111111010111111111011110111111111011100111001111010111101011111
1110110011100101111a11a01111111010011111001111000111111111111111010111111110110010011111111110010111110011011111111110111111111101111110111011111011111100111111
0101110111111011111a01a11111111001110011111111110111111101111111111011101111011010111010010111100101101100111111111111110111011111011111110110001011111111111111
1111111101101110110a01a11111111111111111101111011011111100110101110111111101110111111110001011111111001110111101101111111111111111001011100111111011110111111111
1111011011111111111a11a11111111111111101111011111111111101010111111011111111110111101111111001111111111111101010111011111111011111110101111111110111111111111001
1111100111111111111a01a11110111011111101111011110011111111111111101011101111010011011111111111011111111111111011101111111111111111011110111110111111111110111111
0101101111001111011a10a11111111011011101110101110101111111111001111101111111111111111110111110111011111111110111111101111111111111101111110110111111111111111010
0111111111110101111a01a11101001111111111110010110101111011111101111100011101110111111111110001111111111101111011101111111011111111111110111101101111111111111111
1100111100111101111a11a10101110101010001110000111101111111101101111111010111111111111111111111011111101111111111101111111111110001010011111011111101110111111100
1111111010111011110a11a11111111101111111011101111111111010111111110011111011111111010111111001101101111111111111111110011111011010111111111111111101111111111111
1111011111111111110a10a11110111111111111111111111111100111111101111110111010110111011111111101100011110101110111111001101111111111111111101111101001111111111111
1111111111101111111a10a11111011111111101111100111011101111111111111011101100110111100111011101101111111111111111101110011011111111111001110011011111111111101110
1111111011111111111a11a1111111011110111111111111100aaaaaaaaaaaaaaaaaaaaaaaaaaaaaaaaaaaaaaaaaaaaaaaaaaaaaaaaaaaaaaaaaaaaaaaaaaaaaaaaa1011110111011011110111011110
1111110111111010111a11a1111111111111111111011111111a1101110111110101101000111111100111111111111111111111111111111100111111111111111a0111011010110111101111111111
1111110111101011111a11a0100011111111011111110101111a0101101111111101111111111111000111011011110011011101111010111111111001110001100a0111011111110110111010111001
1111011101111111111a11a1110101111111111111101110111a1111111111111111111111011101111011111011110110111111111111101111111111011011001a1011110101111111110111110101
1111110011101111111a00a1111110111100111111110001011a1111011110110111111111111011101101010111011111111111111111111111111101101101111a1111110111111111111111101111
1111111011111111110a10a1111111101111111100111111111a1111011111101111111111110011101111011111011111111011111110101111111111111011101a1111100111010100101111111101
1111111111111001101a10a0111111111110110101111111111a1011011111111111111111111111111111101111010111111011001111100111101110111110111a0111101111011111111111111101
1111111101110111101a11a0111111101111011111111011100a0101111010111111111101111110111110111110111111101111111111111111111010011110101a1101111100110111111001111011
1111101111111111011a11a1101111100000111111111111111a1111100111101001111011100111111100110111111111111111110110110101111011111111100a1111011111011011110111110111
0110111111111110011a11a1111101111111010001111111011a1111111111111110111111001111110011011111111011011111111101111111001111111111011a1101111111111101101111111010
1011001011111111111a01a1111111111111101111111111111a1111111011111111111111011101111111111111111111110101000010001111111111111111111a1111111111100111111111111101
1111111101100111111a11a1101011111001111111110110111a1111101111111111111111101111101011111111101111101111111101111110110111111111111a1111011111111110101111111011
1111111111111111111a11a1111111100110110111111011011a1111011101110011111110011101111111101110101111111111111111101111111111001111010a1100101111011110111111101111
1111110100111111111a11a1011101101111111111011111111a1110100011110111111010101011011111111101111110110111111111111111011111110111101a1000111010100101111111011011
1011111011110011011a11a0010011001101111111111111101a1111111011111110101011110001111111010010111111111101111111110111111011111111110a1011111111011011111111111110
1111011111101111100a11a1111111111111110111111111001a1111111110111110011111011111111011010101111111011110110111101111101111111111111a1111110011000111111111010011
0111111111111110111a11a1001111101111111011011010111a1111101011110111111111111101101100111011111110111110101111111011111111101110111a1111111111101110111111101111
1011011111111111101a01a1011111110101110001111111111a1111110111111111101111111111101001111111111111110101111111110110110111001111011a0011111111111111110101100011
1111110111110111111a10a1111101101111111111111110101a1111110110110110111111111111111111111110011011101010111011101111111111110111111a1101111101110100100011111011
1011111101111111110a10a1111111111011111111011101111a1111111100111110111111111111011111111101011110111111101100111111010101011001100a0101101110111101111111110111
1011011100111111110a10a1110111111110111110110011110a1111110111011001111111111011101111111111111110111101111111001111101111001111111a1101011011101101101110111110
1111111111111110111a11a1111111101110111111111111111a0110111011110101111011011101111011111111110111111111111111111101111110111111111a1111111101111111111100111011
1111001110010111111a10a1001101111100011111101011201a2112022011111210221100112101111111101111000011111100111110110111001111011111111a1111111111111011111111010111
1111011010010111111a01a1111011111011111111011111111a2211220112022112002211210111111100101111110110110111100111111110111111011100101a1111111101011111011111101111
1110111001111011100a10a0111011011111110110010012102b0002211012212221022122211111111110111111011111110111101101011101111111111011111a1100100011110101110011101010
1001101011101011111a10a0111111110111111101111111101a0110220211122111001202202110101001101111110111110111111010111111011111111110011a1111111111111111001111111110
1111010111111011101a11a1111111010101001100111111211b2112121201211212021222121111011111111111111011111111111111111111111111111110011a0111101111011011111111110111
0111101110111011111a10a1111101111111111101011110112a2112121011220101122220220111110111101111111111111110110111111011101110111111111a1011111011111111011110011101
1111111111101011101a11a1111010110111011111011111111a2211212102212102110211110110111111001111010111111011111110111101011110101010110a0101111111100111110111111001
1111111101111111101a11a0101011111011011111101112222a1201011222011022122222212111111111111111101111111111111011111110110011011111111a0111101111001111101111110111
1111110100110101111a10a1111111101111111111110110222a1012020212010211221112000011110011111010111101111111011111011011011111111111101a1111101100111110110111011111
1111101111111111111a01a1111110001111110111111110111b2102211212102102101222121111111111111111111101111111110011111111110101111101011a1111011101111011111101110111
1111100110111011111a11a0111010011101110011111110220a2201211120212222112101121111101101111111011111111111111111111111111111111110011a1011111111111111101111111111
1001110111110111110a11a0111111111110111110011102122a0112100110022112221111022111111111111111111111111110111110110111010111101111111a1011111111101011010111111110
1111110110111100111a11a1110111111111011110111112210a2211001211212102201012221111111111110111011110011111111111111110111110111011010a1011101111110111000110101111
0111011100111111111a11a1011111111101111011111101022b2212101222112201112211012110111101110110110111111111110111110111011101011111111a1110111111011111111111111110
1000111111110101111a01a1111111111111111011100111121b0212222220222022111221221101111011101111110101111111101111011111111101011101111a1111110111100011111111111011
1101110111111111111a11a1011111110111111111111101111a2112211221112120022022222111111110111111111111111111111111111101111101101001110a1111110110011110011111101011
1111111101011111111a00a1000111111111111011111000222b1110010211221121211110022111111110101001100110011101111111111011111111111101110a0110111111111111111111110111
1111110101011110010a11a1111011111111101001110112112b1210210011212210012101211111011111110110111111111111111011110110001011110001111a0111111111110110111011101111
1011101111111111111a11aaaaaaaaaaaaaaaaaaaaa11112211b121212122222000222221221111111111011011110111111111110aaaaaaaaaaaaaaaaaaaaa1111aaaaaaaaaaaaaaaaaaaaaaaaaaaaa
1011111111011111111aaaaaaaaaaaaaaaaaaaaa10a11111221a011020112122211012022121010101011111111022022112221110b1120010111122222111a010110111011111011011111111111111
111111011001111111111101111011110110111a11a11101202b120221200222111212102102211110111101111112121112122122b2212210111022211210a012210221022120020112011111111111
001111100011011111100111111111101101101a11a00100222a111021212221121202100222111110101110111112121100221121a2122211111110111110b001011011122112201212011110110111
111101011111011010111111112122201111222a11a21111120a221112112120222122021112111010101111111110011211022100b1212221212220212221b112101112212221121120011111011011
111111110101110111011010010211222111222b11b22011211a221121211212001112110201201101110111111122111202102112a2022201211022122221b002220221012102221211111011110111
111111111111111101111111102220210110211b11a12211221b020021211101122121110220111110100011111010221111121121a0111111212202211001a111111121012211010120201111011111
011011111111011111110111112010221220122b22b21112202b111211201200222012210212101111111101101122001212221121a1020212211211221112b022112221220122112111111111011011
110111111100110111111111111101001221221b12a22211120a221102212102211111212112001111111111111101222211201102b0000121212121221200b112022211202221222202011011111111
101111101111111111111011011211121200012a22b02212101b201112202112120121110201101111111101111102111111102112b1211022210122221101b121221221111122102212211111111001
011111111001111111111111121121112212221b21b11202212b010101121201102211221211211011111111110121022011221122b1111210020012211112a222221021210010010222120010212222
111110111110101011111111122011112211111b02a12111011a211122120120212011121211211101111111111002122212122121b2121211100111010222b122021011212121122120221122111110
111111011111110111111101122111121121200a12b02112212b121222011201121121121112211101111111111022111111102100a2200021101121012112a111112210010220021211001112122112
111111110001111111011111122120121222020a10a21010101a111211101110101110111111111111101111111112211111221112a0122112112222121122a112101001021020120211221221102102
010101100111111101111111101012111012011b01a12112211a121101111111111111111101001111111110111122022210012122a2222211122211121121b222212112221201012102021112210211
111011111111110111011101111121222012112b11a20110110b101211110111011011111111111111111111111120121100111011a2012212002111220102b021211221022021211121011212202122
101111011010110101001101120212011021020a20a21202222a211210111011111110111110110111101111111101220212001112a2212110110220122010a121121001122121220201121111111201
011111011111011011111111121100012021021a21a12010222b011001110101111111110101111111111111110112221200122122b2210112222122212111a110102022120112102211121211011201
011111111101101111110111112111121102121b11b22011101b210101101110101110110111111111111111111121022111212121b2202212201101102221b022111210121201202211221122120202
001111100111101011111010120201222221010a21a20210201a021011111101111101011111111111111111111111111210010112b1210111011222200011a221222122102110112022100112112221
111111111110111111111111101010111101011b20a11102021b111110111001111111001111111011111120011111202201101110a1111111111111222210b201122122002102211122220201211012
101011111111100111110111111101101010011a11a21001221a122211011110111011111111110111110222110122012221012002a1011212101211111022b101120121102112212222121222200110
110111110111111100101111121022120020012b01b11112022a112111101111110101111101011011110211122111121111112122b2012201001001222202b111121021022012211110011020022212
111111110100111001111111121122221102021b21a11012111a110011010111011111011111111101011120211112121222211110b0001212222102012110b121101210200021110220220220201221
011001110011111111111111102021222021110b21a11211211b211111101111011011111111111111011122020111211102211121a1102011102212222122b010022212202211112110121112121221
111111111111111111101111101112122221122b10b02011101b120111111011111011111110101111111220101222211211110110b1202021002200222001b111222022221201101120211211122222
111011111010111011110110000100210112120a11a10201111b101211111111101011111111111111101200211111012102210111b0222012102110210022b101101112221121011202221121110111
110110101111101111110100110122110121222b10a02210220b212211111011111011111010111110110212211220121120121101b0211112012211111020a021112212111111202011221220210102
111110111010001111110101112212122212220b20b22112002b101111111110110100100011110111111221021121112211021021a0122201110111111220a111212201112210212111210102112121
101011110101101011111111101101122222111a21a21102022a211011001101110011011101011111111121111120022221210102a2121011110000211111b122122012210211222121111121202112
111011111111111111111111121122011111221b11b12112122b210211111111111101110111011001111212221222211221121112a1102222102011220012a021022121001020201110021221220111
111010110101100111101111110211201001112b11b01112121b111111111111111100110011111111111222122202111121001111b2122202010211111210b012010022222022221211111002101000
111101111111111111011001111001111201122b10b21111021a201211100110111111111111110110011211112010122220211112a0011122101111122222a112100221121011110001221200011112
111111111111100111111111122100100211220a12a20211110a222110111111111111110110110111111012221120021001201022a2010211222002222112b121222220110111202210121022112111
100011110111101111111001111200010211111a21a21211111b212201111101011100101111111101111212222202111001212021b2110212212112122012b112221010211010112110211022001202
111101111011111111010111011011111111111a11a11110101a011111111101111111001111111111111221122111111211112012b1112122012111210011a101100211210002111112111212210012
111111111111110000111110110100100100011a11a11101011a110011101111111111011110001101011100012102211120221111a1202010021102121220b121211202212122012211011212102021
111111111111111111111001111101110110111a11a10011110a001111011110111111111111111001100022022102012222121021a1100222211201112111a221220121222212121200101011110221
111111011111011101100011111011111111100a01a11111101a101110110111001111010110111110111202022002101012110112a1220122111210111211b012121112211122202221210022211222
111011101111110100110010111111110111111a10a11011011a101111111111101100110111111001010011122201212022110112b2212212110212210211a012011122011002121122201221121110
101011111011111111100111110111110011101a11a11000111a111111110111111111111111111111111101111111111100111011a1111111111001101110a101111011000111011111111111111111
111101101111101111111111111011110111011a11a01011110a101111110111111111111111101011011121122112220221120122b1111022121101210221a012222012210121212111111111011111
111111111101011000111111110111111111101a11a11111011a100111101111101111101111110111111211101202210201102020a1222221110202221211b001111221221221202211111101110010
111011111111111101110110011111100011111a11a11111111a111110111011111101111101111111001201111201112212112121a2021222011212222021b121101121212212211211111011011111
111101011011101111111101011001111111111a01a00001111a111111101101011111111111111111110211222202220012122112a1210122212111210011a022112212222211220210111111110111
111111111110111111101111101111111111101a11a10111010a111111111110111111101111111111011100112211010210210011a1212222211110210221b112211022212212122111101111111111
110111111111110111111110010011111111111a01a11110000a111101110111111111111110111111111212222122211202021011a1121112221211210111b112111112120011201001011111110100
111011111101111110111001111111111011101a11a00110111a111101100001111011111111101111111221021201112212112121b0011201220212212110a111201101122211212111111101111111
111110111101100111111111111111111111100a11a01111110a110111101011111111111111001111111210210211222212211101b2202122122212211101b110212210212111012111111101100111
111111001111111111110101111111010100111a11a11111100a111111000101101111111111111111011210011220022121110122b2112121111001101111a111112021121111221111010111111111
111111010101011111111111111111101001111a11a10111111a010100111111111111011101111011001111102112102110122011a2222111212101112101b101112112211222002111111111111111
110101001011111101111110111111101110011a11a11111101a110111111011111111100101111111111111110111110111111111a1011011102201120021b021111120211222122111111111111111
110111111111101011011111011011111111111a11a11111111a111111101111011101111111110001110111111110111101110111a1111111011212222111b011011110211211011111111011111100
011111111111101111111101101111011001101a10a01111111a101110111110110111111101111111111111101111111011101101a0001011002111100121b110010002211102022201011010110101
111110001111111110101111011111111111111a11a11001111a111111111111111111010111111000111110111111111111011011a1111111121010211211b121021211211122112211100111011111
111111110011110110111111110111111111111a11a11111111a111111111000111111101111101111111110101111011111111110a1111010111111210120a012022102200221122011011101011111
111101111101011111111111011101101101011a11a01011111a101110101110011111111111101111111101110111110110110111a1111111101002222121a102202112011221021111001101111110
100111111101111111110011111100111111111a01a11111011a011111111011111111001101100111111111111011111111011111a0011101122011210221a112111002012201212111010111111111
110101111111111111111111111101011110011a01a11110101a101111111111111111110011111001110111100111111010110011a1111101020202121001b112202012211222120111011111101111
111111110110110111011111110011111111110a11a11101111a111111111111111101111100110101111111001110111100101111a1011111111111101011a011010111111101111111011111111011
110111111010111111101010111110101111011a00a11111111a111111111111101111111101100111111101111101101100111101a1101111111110111010a001010111111111101111011111111101
