107 73
16 143
104 5
110 22
5 12
103 101
18 97
65 59
59 34
9 61
01111111110111111111101101011111111011101101011101111011110011110110111111010111011111101001111111111111111111110111111111101111111011110111a1100111110011010011
11011111101111110101111110101011101111111111110110011101111111111111111111111111010110011111101111110111101101110111111111111111011111111001a1101011111101111111
10101111011110011001111110111111110101111101111111101111111111010011111111111111101110111001111101111011111111111111011111111101011110111101a1111110011111111101
01111011011111010111101111111111111011111111110110101110101101111111101111111110111011111110111011101011000011111111111011101111110111011111a1111111111111111111
11110111111011111110101100111011111101101101010011111111111100101111111011111111111111111111111111010111111111111110111111111111111111110111a0010110111101011110
10110111111111121021122001122211211011221110111111011111111111111101111111111101101111111111111111111101110111111111111011111011111111111111a1111001101011101101
11111011111111121212101102220121221112221101111111111101110111111011111011010111111111110111001011111111111111011101101110111111111110011111a1011011011110011111
11111110110101210101211110101001222121222211111111101111111111110111111011111110011101111111111111111110101101111111111111111011110111001110a1111111111101010110
11011101011100120221212121202121222201221121111111111110111010111100111111011110111111111111011110101111111010111111111111111110111011111101a1100111101111010111
11111111111011100111111120111001121111221121110111110111011112011212111020222010111020101122011111111111101101111100111111111110111110111111a1111111111110110111
11100111111122011222101122012022122211222221101011111111001012211121101200112122111112120122111111010111111001111100111110111111101111101111a1111110010111111011
11111001011111012212122212121022111111111221011010111111111102222221221122221002020120002100101111111111001111010111111111111111111100101101a1111111111011111101
11111101101111221211112011101221212201021121111111111111111011221112221222211012011111112020111111110111111111110111111100111101011111101101a1011111111011110110
11011111111120000210022010122202111122012221111111111111111110222022100200000122111012222221111011110111110110111110111111111011010101110110a1111111111111110111
11111101111121112211001221201222011212010201111111111101101012212122212022211111021111011121011111110011111101111011111111111110100111110111a1110111101111101110
11111100011110111111101011111101011110111111111111111011111111101111111111101111122212222211101101011111111011011000111111011101111001111111a1101111010111110110
11110111111111112110002111000111221110121220101011101101101110022212220102121101211111011022010111111111011111111011011110100000111000011111a1101111011111110111
10111111101122211211120122012210211111111121101100011011110002110121101012112211222012112212111100111111111111110111111101011101111111001111a0111111101111011011
aaaaaaaaaaaaabbbabbaabbbabaabbabaabaabbaa111111101110111110011112211202201010212220101121112111112002210221211102221212112100220110101111111a1101110111111011101
1110111111111011111111111101111111001011b111111111100111111111011011111111111101101100111011110111111110011111111111101111111111111111011111a0111111111111010110
1111111111111101110111101111111111110111b111111111110111111112210211211221011211122212222201011111112222102111200022120122221220101111111011a1111101101110101011
1111111100111111022111112120221011022222b201011111111010111102101111121222022102221201211111111101022110202121112022112202210110110111010111a0010111101011111011
1111111111110001111111101111111111110111a121110111111111110111221000120021022202011102002121110102110212220200122211112221212002110110111110a1111100111111111111
0111111111111101111110120122222122122211a121111011011111111111112211211222101122110122120112100111110020121111121022112220221210011101111011a1111011111110110111
1111011111110011102111220211001202112100b200011111111011111112112111211000222102102020210012111112212201112112120122111222011112101010101011a1110111111111101101
1111110100102102121112211122121111110021b201111111110111110011211111121210221212022010201201111112222221122011221102221021100221111101111111a1011010111110000011
1101100110101111111011111110110111110111b120001101111111011110101112101011212102212022121102111012111021112212222211211122022112111111011111a1111111111110111011
1110111101001222022012112222212112221110b120111100111111111101111111111222012011020221221101101002210222101201112111101212121222111101110111a0111111111111101101
1111001101010011220212122121220122212102b211011111110101110112101102121112021110212220111021111111022111212202211111221112011012111110111010a1111111011111100111
1011110011110022221010111111122112212101b120101111111110111110211201110120212201211210022112011112122122221212212022121022222120101011001111a1101111001011110011
1111000111011101011111111001111011111110a211011011111111111102221211121112111221220121200202111111221001012121111120211210222201110101111101a1111110011110110111
1111111101112122111022122112211111112022b201010110111110111101111011020221212211012111121022011101011221210202220021221112111121101001111110a1011111111100111111
1111111011111222121110022210111211000202a211111111111101111012001211022111112122020121102112111010102211100121012211212121021112000011101111a1101111111001111111
1101101111110220112102111012211110221121a0211011111111111001aabbbaaaabaaabaabbbbaaaabbbbaabbaaaaaaabbbbabbabababbababbbbbbbbabbaaaaaaaaaaaaaa1111111101111101111
1110111110110001120221010211221201201200b1101111100111111110a001211011011212121111221212101011111210122221021110102012201102111110111101111011110101111111111101
1111111111111121122122021112221201121111b2201111111111011100a101011101101221222201022002212211011212122101201011212202222201111110101111111110110110111101111010
1111111100001110111111101101111101111101a1111111111111101101a122121212212220222111212120111111101111101012022011220122221212120200011101100111011001111101111111
1111010011111111111111111110111111111111a1111111111111011111a0111212021220021102010210200021110102110121010212222020120bbbbbaaaaaaaaaaaaaaaa11101111111111001101
aaaaaaaaaaaaaaaaaaaaaaaaaaaaaaaaaaaaaaaaa0111111110111111111a2110211112222221111110011122222111101210222211001102122021b2112120211111000111a11101111101111111111
101111111110011010111101001111111111111110111111111101110011a1111001110011111110111111010101111112110001222221111021201a2111222011111110010a11111111111010111111
111111001111111111001011111111111111011111110001111011111111a1111111111100111010111001111111111111120121110122122102112a2211011111111111011a01010111111101110111
111111110110011111011111010111011101111011111011111010111011a0111110011111111111111011010111111111111222112101221222222b2210111011111010111a11111111111111101001
111111111111011111111111011111101101111111111111010111111011a1111011111111111111111110011111111010120121212121122012201b1120000211111010111a01111100110111110111
111111111011111111111111100011111111110101111110111111110011a0110111111111011111111111111110110112002222220111212222212b2112101001110111110a11011111001101011101
111111111111111101011111111111111110101100111111101111111110a0111101111111111111111101111111111111200111112221012211221a2012212011111111001a10110111111111111111
110111101111110011101111111101110100101111111111111011111111a1011011100111110111111111110101111001212012221122212212112b2011211111111101111a10111101011110111111
100110111111101011011010110011101101000101110010001111111011a1111111111111111111111111110100111110221220002201220002012a1211002111011101101a11111111111111101111
111101101111111101101010111111111111110111111100111111011111a1111101111010111101110111111011111102221211221101112211211a2111111110111111101a11111011110111111100
110110111110111111101111101101101111111111111101111111111011a1111100111111011110110111111110111101222121111222111122021a0220002211111111011a11011110101111111111
111001010111111101111111111101101110101111111111011111111111a1110111111111111110111111111001101111110101011111111011111a1111111111011110111a11111110111111101110
111111111111000111111111111111011100011111111001101111111111a1110111111111101111110111011111111011011111111111111110111a1101111111111011111a11010111111011100111
111111111110111111100111111101111111111101001111111111011011a1111111111111110110011111110111111111111111111111111111110a1011110101111111111a01111111110110111101
110111101110111111101111111111111010111101111111111010111111a1101111111111101111111011010110011111010111010101111111111a0110111111111011110a01111111111001101100
aaaaaaaaaaaaaaaaaaaaaaaaaaaaaaaaaaaaaaaaaaaaaaaaaaaaaaaaaaaaa1111010111110100111111110011110111101101101111101001011111a1111111111100110100a11111000110101110111
11111111101100101101111111010001111111010110101110011101111111111111111111101111111010111111011111111111111111111101010a1110011111111011010a10111101111000111111
11101010110110011111111111111111110011101110111111101111110111111111111111111111111111111111111111111011111101010111111a1111111111111010010a11101111011111111111
11111111101101111111111111011110111111011101111011101011011110011110010010111110111110111111111011110110101111010110111a1011111111101111011a11111010111101001011
00011111101010010111101001111111111111101111101111111011111111111111010110111111110011111111101011101011111111111111101a1111111101111010101a11011111111111010111
10111011110111111011111101111011001111111111111111001111101110111101011110111111110110111111110101111111111100100111101a1111111111111111011a11101111110101101111
1011111010011111101110100aaaaaaaaaaaaaaaaaaaaa1011101111112122211110111111011111111111111001101111111111111111011111111a1011110111111111101a11111111011011011101
0111111011111111011111011a1111110112001220121b1220211122000121011111111111011110111111111011111010101111101111111111100a1111111111111010111a11011111110110111011
1011011010111110111011110a1100011111101112210a0110022112112212021111111100101111111110111010110111111111011101101111111a0111001111111111011a10111111111111111001
0101011110111111111111101a0111001122001001221a2122100220200021011111111111110111111100111011111111110111111110110111111a1010101111111001111a11111111111110011111
1101111111111111111111111a1111111110002211212b0211211222011112111011010011111110111101110011111111110111110111111111111a1011101101111100111a11111111111111111111
1111100010011111101111111a1011111110212222210a0020111122111100121101111111110111111111111110101111111111101111111010111a1111111101111001111a11011111111001101011
1101111111010110101111101a1111001120110120121b2000212221212212211111222111120201121212122111111111111001110111011111110a1111111101101011111a11100111011111110110
1111111011111111110110110a1101111100210110211a1111220102111122121011210121202122212012112011011111011111111111011111110a0111011111011000110a10100101110111111110
1111111111010111111111111a0110100110111212110a1111211212212120021101122101122120221212101111100110111011101101111111101a0111110011011111011a11111101111110111111
1111111111111011101111111a1111111121112112211b0222122021112212221112222221012210222210122201111001111011111111011011111a1111111111101111011a11011111011111111110
1101111111111111001111111a0111011121001011201a1120002011112221220110212120122122111210221101110110110110010011101111111a1111011101011101111a01111111111111111111
1101111110110111111111111a1111111120212122111a1111001121111021220102211122110100201111210211111101110111101111110111111a1110111110111111001a11011111111111011110
1111011011011101111101110a1111111020111110010a2010211212211220011112122102102222210012112211111011111111010011111111101a1111111011111111100a11111110111111010111
0011111110110110111110111a1101101120210222022b1022111112202111011112222212210221222211111011111101110000111111010101111a0111011111111011101a11111111110101111011
1111101011101011111111111a1111111111211222010a2110101221112101221110221000120112221202110111011011011111111011101010111a0101011111011011111a11111110111111111111
1111101011111111101111101a1110101121112021111b1212112211101211001111221122212122122210112211111110101111111110011111111a0111011110111111101a11111110111111101111
0010110111111111111011000a1111111021111022110b2001201112211212001111221211122012120202112011011111111110111111110111111a1111101101111011111a11101111101111011111
1101100011101111111111111a1011110111112202120b2021121122110102200112122221022122100112100100111010111111111111101111110a1110111110011111110a00111110001111100011
1110111110111110111011100a1111111101111222121b1212111121001021111112122211202000120111222111011111111111111111101101111a0110111011011101111aaaaaaaaaaaaaaaaaaaaa
1111111111111011111111010a1110101112212210021a1121210112111222121111212211122221111201201211101101111101011111111110101a1011110111110111111111101111010111101111
1111111111111111111111111a1111111011100220110a1111111101101011101011011111010111111110110011111110011110111111111111011a1011101001101110101110101110101111011101
1011111111100111111111111a1111011101110201021a1120212101111022011111121221111022121002020211111111111101111111111111111a1101111101111111011110111111111111111110
1111111101110111111111111a1111011012110221001a0202022211110121121111121112222112011122120001111110101010111110100110101a1111011001011100111111111110100111111110
1011111011101111110111110a1111111120211211111a1211221211212221020111201212211102011000111011111111111011111111001111111a1111111101101100111111110111111111011011
1111011100110101111111101a1111101122112221221a1212122112210200111111221121122110200112111111011011011111111110111111101a0101101111111111111111101101011011001101
1001111011111100011101111a1111011111012210221b1202201000110120201101211112111120022211100011111111111111011010111101111a1111010011111111110111111011111111111110
1111111010110111111111000a1111111001210121121a2010211101212112111112101102022220222100111201011111111111101111101111111a1111111110001111111001011011111101111111
1011111111111111111111111a1111111121200111111a1012221011212202001110201020121112222020011211011111101111110111110101111a1110110111111111111011111111111111111111
1101111111001011111001111a1101011110212101221b0110010222111022111111222220220022211011222111101111111101111111010110111a1111111011111001110111010111111111001111
1111110111111111111010111a1111111021211101200a2121221221110210111111122222021222120101112100100110111001010111111111011a1011101111101110110111101111111110100110
1111111111111111110111110a0111111121002221111b2002110202102211220102222202011020112111012101111110111011111011111111001a0010101111111101101111011101111111111111
1111111111111111111111111a1111111111111101011a1111011101111022121111011110111122112121201201111111111011111111111111111a1101000111011111111111111111111111111111
1111111011011111111100011a1011101101111111101a1111110111011112111012102112220211211121122111011001100111111111111011011a1111111110111110111101001110111111111111
1111011111011101100111111a1011111111111111111a1011111101100200121010121122110102012211120011101011101110111011111101111a1111111011111011110111101111101001111111
1111111111111011111111111a1111111111111110100a1011111110110212120111201002122221212200112111011110010101100111110111011a1011111111111111110111010111101110111111
1011111111111101111111011a1111111011111110111a1111111010111221201102112121112210002111011011110111101111000101111101011a1111111111111011011011111111100010110110
0011111111110111110111110a1111011111111111111a1110111111101101121110011201211121111011201111111100110101010111111011111a1110111111111011111101111111111111111110
0111110011101111001111111a1011100111111001111a1010101111110111101101111111101011111110011010101001111111100101111111111a1111110101111110110111111111001011111111
0111111111011111010111110a1111111111111011101a1111110111111011111110111101000110111011100100111101111001111011110111110a1011111111011111110111101111100111110111
0101111100111111111111111a1100110011100110110a1111011111111111111110111101111111111111011011110001101111111110111001110a1111110111111111111111110111111111111111
1111010111111111111111011a1101111101111111111aaaaaaaaaaaaaaaaaaaaaaaaaaaaaaaaaaaaaaaaa101111110111100111111111111100111a1110011111011101111111110010111010110111
1011011101111111011111111a01100111110111011111101011110110011111111110011111110111111a111111101011111001111111111111101a1111111101111111101111111000011110111111
1110101110110111111101110a11111111111101111111111111111111111111011111111111111011111a110111011111100111101010111111100a1011111111111110111111111001111001111100
1111111001111111111111111a11010111110011100111111011111111111111111111111101111111101a110111111011011111111011001110100a0111111011111111111111111111111110100111
1111011111111111111011001a11011111111111101111101111110111111111111101111101011111101a010110111111111112110021211211202b2110210111011101110111110111111111110111
1101021212020121202211111a22011112211111111110110101111011111111111011111111111111010a111101111110000112201212112211002b0101211211111111111101001001111111111111
1101122022022122101011112a20211122001001011011010100111011111111111110110111101011111a110110001101101121112021220020211b1222102111121111111011111111111110111011
0010100221222122211201022a21211111121111110011011011111100101101111111110011111101010a111111011111001011111201222212021b2110121210111111111101010011110011111111
0011112121112112111111121a22220122121100111111111111011011111111011110011100110111101a111111011111100112112002222222122b1221111011221101001011101111110111101111
1110120211021112202102211b02111101211111111011110111011010111101010100111111111111111a111111111111111022122110011101121b2201112221211011111111111111110111110110
1111121221111110211210112b12221102101111110011111111110101111101111111111111111111101a111111111111101110212201101210222a0112101011220111111111111111101111011111
1010112111222102202212122b22220121022112012012102112211011111110111011001101101101101a111011011111110110022021121112111a2110112221111110111001111111111111111111
1111122221122112211210122b10121021102122011102111212101110011111111100111101111111011a111111111011111111121112111211021a1111222110101011101111101111111111111111
1111102100012111001012021a10211122121112112212121111201111101011111111101111111011111a111111111111111121212201221201220a1112222202111110111111111111011111110001
1010112212221101010111122a20221120121112102110112101111111111011111111010111011101110a111010011110111120021221202102122a0120112101001111011111110011010110111111
0111112100200022211012222a02010101212120212211102121110101111111111110111101010010110a111111111111111110212212001112221a2111221110201111111011111111111111111110
0101111100111100111112221a10201122001111202210211220201110101011111110110011110111111a011111101001110121111122101211010a1201021022221111110111110111111111010110
1111122010222121111211111b22111112221002212210202121111110101010111111100111101111001a110101111011111102221121121122110b2122222111100110111111111110111111011111
1111111101022121112202222b21201102122120211112122221111111101101111111111111111111100a111101111111110122012112220222210bbbbbaababbaaaaaaaaaaaaaaaaaaaaaaaaaaaaaa
1111002212212101211012221a21111000111122212201110010111111110010001111010111101111011a10111111101111111211110101210011101021122001011110011011110011110111111111
1101111111102101111112101b11021121102102111112112100101111111110111111111111111011011a11011011111111111021020211010110210111220100121111110111011011111111111111
