104 27
5 140
65 2
118 98
70 43
30 129
99 98
90 126
8 3
34 44
0111110111111111011010011110111011011111a1011101001a1111011010010111111a0111111111111101011111010111110011000111010111011a11111011111111111111011001111011111110
1111111111110101111111111111011111110111a1111111001a1110011111101110011a1011011011110111111111111111111110111111110000100a11111111111111111110111111110110110111
1111101111000001111111111011000111101111a1111111111a1101101011111111110a1111111101111111111111011111111011111111110111011a11111111101110011111010111111110011110
1010111111110101101111111011101111111111a1111111111a1111011111101111111a0111101111101111111111111011101110101101110100111a11110111111111110111010111000011101000
1101110111111111111011111101110111011111a1111111001a1110111001110111110a1111011111111100111101111101111111111111111111111a11101111011111111111110101111110111111
1111101101101111111101100111111011111111a1111111011a1111101111011111110a1110101101011111011111101111111110111011101111111a11111011011111111111110100111111110111
0110111111011111011111111111101011100110a1111111001a1101110011111110011a0111010111110101111111010111111011111101111101111a11011111110101110100111110111111001111
0111111111101011111111111111011100001101a1101111111a0110111110101111111a1111101111111111111111110110111111110111011111101a11111111111111111010101011101111011111
1112001111201210212012120120211021101010a1111111011a1111111100101010101a1110011111111110101111111111111101111101111111101a11101111111111111111111110111101111110
1110122121121222111002110112212022111011a1111010011a0100100101101111111a1111111111111111011111111011111111110101110101111a11111111101111101011111111011111111011
0112111102121112211112120111121122101010a1010111111a1111110110111111110a1111110011111101101111111011110111111111111110101a11111111101010111111011111111111111111
0112111010122210212112221202112222111110a1011110110a1011111100110111101a0111111111101111111011101111111110111111111110111a11111111111101011101101101111111111111
0111012020222102021211021221022221110101a1111111111a1111111111111101111a1111110101101110111110011111111111111010111101001a11111110111111011111111111111011111100
1111122121120212222212201222102110011101a1111111011a1111111111110111101a1011111111111111111111110111111101111111100110111a11111111111111110011110011110101111111
1112020202121202121112221110221202111011a1001111111a1111100100111111101a0111101111111111111111110111111101111111111101111a11111111110111111111011100111101101111
1112220211112212221210202201120212101110a1011111101a1111111110111011111a1011100110101011110111111111101111111111111100110a11011011111101111011110111101111111110
0011222120022102211012111010101011101111a1111101011a1111111111111011101a0110111100111001001010011111110111101111111110100a11100111001101111111111111101111111100
1110201002112212211112222120121111111111a1111111111a1010011111111111111a1101001110111011011110111101111101010111010111101a11011110111110110111111100110111111101
1112112110112102002112012110122122011011a1111101111a1111111111111001011a1101111111111101111101111011111011101011111111111a11011101101101110111101111111101110011
1112201202210211121111022201220111111111a0111110111a1111101111111101111a1111111111111011110111111101111011101111111111111a11111111011111111110111110001111111011
1110012211121110012212101121221212111111a1111110111a0111111111011101101a0111110111110111101110111101011101111111101111011a00111011111010110011100110101101111011
0112112221212202111212210101111120111111a1011011001a1101011101111111111a1101111011111110111011011110111011111111011111111a10011101110100111111011111111111010110
0111110121102221201111110111221011111111a1111111001a1111100111100111010a1111111101011101111111111111101101011111110101110a11011111111011111101111011111111111010
0112222211100200211210110022221111111111a0111011111a1111011101111001110a0011111111110011100111111111101011111111010111111a10111111011111111101111111101111110111
0112002112212102100010122122102011110111a0101111100a1111011111111101011a1111111101101001001100111111101111100001111111011a11111111111111100011111101111111111111
1010122220111201221012201200111201110111a1110111111a1111110111111111111a1111100111101111101110110111100011001111111110111a11010011111111110110111011011111111111
1110022211101012200111221111212111110101a1111101011a1011111111111111110a1111101101111111101111011110111011111111111111011a11010101101100111101111111111001111011
1012211111221121202001210222110012111001a0111110111a0111110001111111011a1001011111110111100101011100010111111111111011111a11111101111110011111101001111111010111
1012221221002020121101222101201000110101a1111111101a1111011110111011010a1111111111111111111111111111111111111101111111111a10111111111111111111111011111011111111
1110221022202120210111220222010212111111a1101111111a1111111111111101111a0111111111111100101111101111110101101011111011111a01110101011111111111110111111101011111
1010112101012221202112222121221021111111a1111101011a1101111101101001111a1111101111111101110011101111111111100110101111110a11011111121221022122100111012112000212
1112121111102212121010200012111212111111a1111001111a1111110101110110011a1011111110111110111111110001100111100111111111010a11110011221211122121202112122211201112
1111212220120202122011120122021012101101a1011111110a1111101111111111000a0011111111111111111000111011111111110101011111011a11111101211212121021112121211110111011
1111011111111000111111221112121122010111a1111001011a1011101111111101111a1111111011111101111111111101010110111101011011111a10101111120211120101211211111001111211
1011002111201020020212112100212011101011a1111211011a0101021102212121112a2111111111011111110111111111101110111101111110010a01111110211221111122212122122221122102
0011201111201221221011222101201202111010a1101220111b0221122122110011102a2210111111101111101111101111001100110111010101111a10011111021122221210121111201212021212
1111111010111111111011111101011111101111a1111121212b0212221002211222011b2111101111110011111101111001111111110111111111111a10111101210212212022222221122211201121
1110121101121212021112121222210111111111a0112121012b0211211221101121220a1110101111001111111110111100011011111111111110011a00111111112000012222121011121122222012
1110221022202122112212212121120212011110a1110112101a0102021212112121201a1011101011101111111011111001111101111111110110100a11111111221122222122221221212211221101
1110100111110111111011111111011111001111a0011220120b2221021002001222121a12111101111011111111111111001aaaaaaaaaaaaaaaaaaaaa11110111211202122222110101121221212102
1111111111111010101101111111111011111111a0110202220baaaabaabbbabbbaaaabb00111010011101111011111111111a1110101111111011111101111012020011121211202221112212112212
1110111111111111111101111110111101111011a111111221220002112012211112101221111111011011111110110111110a1111111111011111011110111112022210120112010111211112011022
1111111111111111111101100001110011111111a111122222222221112012021111211211211010111101011111111111111a1110111111011011111101001002110221220211222212212121100212
1111111111111111111111111110110010011111a001201110122122122202201100101212111011111111111111111011110a1111111111111111111111101111111121220111122121202020121112
1011111111111011011111011110111110111000a011221102111212212001120112112211110101111010111011111011011a0011110111111111111111111112220122121221221220122112112222
0011111111101111111111111011111111111111a100202220021222121211112121112021211011111111100011110101001a1111110111111111111110111110111222111221110222102121212022
1100111111110111111011011111111111111111a111221100120122200012111122102221210111111011111111011101110a1101110101111111101101111112111102111211220222121221021110
1110110011110110011001101101011101110011a110221002121112121112121022122220201111111110111111100011100a1111111111111101111100011110021021222112121121101221120112
0110101111101111111110111111001111011101a111111122212212212021112102101201211111111110111111100110111a1011111111111011111101111111200112121202111111011212122112
1111011111111111110101111111111011111111a111122210222221111110221122111212111111111101101111111110111a1101011111011111111111110110202112221221221220012022102211
1111111111111111111100111010101101111110a110211022121111112112222122221111101101111001111110101100111a1111111111110111110111101100121112102210120211221210121101
1111110100111111111101110111011111110110a111021012221122020000201112202221011111001100111101111111111a1111011110111111011110111100222222121021212012111110021100
0111001111011111111111111111001011111011a111100101101112101002121211210212111111111111111101111011111a0011101111111111111111101000012201221202001120212000212110
1011111101111111111111111011111001111111a111112211011121222112111112111121211111000111111111111111111a1111111111111011111111111012210022000201211111211110200122
1111111111111111111111111111111011101111a111111122122112122121200122212222210011111111111001011101111a1110011110101110111001111112221022122212211120122020201222
1111111111101111111111111101111010101111a010022111212201101120111212212121211110011111111111011111111a1011111110111101011111111111111021111221212221221221112220
1111110111111111101111011111101111110111a001121211111111212122111202211211210101011111011011111111101a1011111111011111100111111112211212112222200100220012222002
1100111011111111111011111111111111111101a111020022210111212021210222121211201111110101111111111110111a1111111111111100101101111101000211102120121211211100201222
1111111111111111111011111101011111011110a001121200001022101021201110101012111110111111111101001111000a1111110111110110111100011111112100001222111012012112212002
aaaaaaaaaaaaaaaaaaaaaaaaaaaaaaaaaaaaaaaaa101110211011122011112010101221121010111111111110111111111111a1111111111110011101111111102221122102101102101212121101202
11110011100111110110111110111111101111111101000221020221212011111000211101011111101010110111111111011a1010011111111111111001011112022212002102222212010111211212
11111101110111110110110101111111001111011111121121111111222110200100101111111111111111110100101111111a1111111110110011111101111101011111101100001111110000111111
11111111110110011111111111111111011111011110011211102012112010221222221121111111111010111111011111111a0011111111111111111111111111111111100011011111111110101111
01110111111100111111111101011111011111110111111222221211220220221102201021111111100111100011111111111a1110111110111111101110101010001001101111011111111101101101
11111111011111111101111001111110111111111111022121220220002102210211211212211110011111111101101110111a1011111110010110101110100110101110001111111011111111101100
11222222102101202021011222112100011111001101010111010111100011101111111111111111011010111101111111111a1111111111011101101110111111111111111111110111111010110011
11201201210110222020102012212122211111111111101111111110011110111011111111101111111111111111111111111a1110111111111111111011111111111101110111111010111111111110
11101211211201211101112211112002210110011110111111101111111111111011110101111111111111111111111110110a0011111111111111011111011111111111111111111111011111111110
11121222221121211211222221211111011100110011111111111111101111100111111011111011111110011000110111111a1111111111111101111111111110101110101111011101111101111111
11020212112111210022211111202111010111001101111111011111010000111011111111101111111111111110111111111a1111111111111111111111111111111111011110011101011011111111
11212100212212010112211110220122110111011011112210010202020201010021121221101101111111111111101111101a1011111111110101111101110110110100011110101101111111111111
11201222121012202100112102121201211111111112102012221001221011012012011202111111111101110001111100111a1111111111111011110111111111111110010111110010111000111111
11211012222121201021221222211120111110101110012021112002021210221112122111011011111110111111111011111a1111111110101111011011111111111011111011101110111111101111
11111101101111111101121021121212011101111111122201011201212222011211211111111111111111011111111111111a1110111010111001011111110101110111110111101111111111110100
11111211011210022221112120221011011111110112201110012112021112221222221012111111111101110111011111111a1111001111101111111110111110101111111111101111111011111100
11221110112000122221112211112111211111111110211222221111012020021122111111110111110111101110111110001a1111011111111110111101101111111011111110101111110111111111
10200122111222110221121221112121111110111012212102122020011212211112122122111111110111111110110110111a0111111111101111101010111111111111111110111111111111111110
11220012210210111120012111222122201111011111002222210202122210202201120202111111000111110111111111111a1111110111101111111111111001111011111101011101011111001111
00101122220121221211121001011212211011111000200211111120111211201222120201111011111111011111111111111a1110101111111101111111101010111111110111011011111111111010
aabbbabbbabbabaabbabbbbbbbbaaaabaaaaaaaaaaaaaabbaaabbaababaabbbbaaaaaaaabbaaaaaaaaaaaaaaaaaaaaaaaa101a1111111101011110111011110111111111111100111101111111101110
1122222101111011110201112112012210111000111202001121122112122110012100121111111111101111111110101a111a1011111111111111110111100111010110011110101110110101111101
1111022222102101220112111202021110111110111020212222111021201101102102221210011001101111111001001a111a1101010101010111111111101111111011011110101111101010110011
1120120222120122112010112121211121111101011121121222221212112210021212112210110111011110111111101a111a1111000111111111111101111001011011011111111111111111111111
1112211112222112222012110202221001001100011111212122211101222120102110221101111111111101111111111a111a1110111010001111111111111111111111111101011111111111111110
1111212102122111121002110202222120111111111120102212212222102211022100212101111111011111111000111a111a1101111010111111101111111111110111101101111111111111111011
1010221112222121012212212211122220100111011110201221210011111001110200101211101111110111111111111a111a1011111111011111001111110111101111111011110111111111110011
0121011112001120211111222112211221111101011112221111100112022120021101221111110011111111111111111a110a1111101111110111010111011110110110111101110111101111101101
1111122012112120211212002221021211101111010221221111211112022121021112210210101111111111011111111a111a0011101111111111111010101101110010110011110111011011011110
1022112220212121212111112022211211111101111011122120211122222102112112102211101111111111111101111a011a1111111111111011111111111111111111111111111110110111110110
1111202102122112121200011111122201111001010211122220000211022121221021022111111111011101101111111a111a1111111011100110111111110111111101110111011111111110111110
1111210121121112210111021222121021111011010112112221120211220011102122222111111111011110111111111a011a1111111111101111101111111211210111110022210211120112222101
1101200220121110122212022111221221110110111210011210222101222211100220102010111011110111111111111a100a1011111100111111111111112121111222101221212222010221212110
1122210122201112222211202101222111111111111220121112021222110222112221221011011111100111110111111a111a1001101111111011111111110110221111011121212211212101210011
1122100202202120120212110021112211111011111100012011111111212122122222122211110111011100011101111a110a1111110111110110101111001222201122221120100222101122020111
1012122102121111121010121120122121111101101201201120121021201111010101112101011111101100111111111a111a0110111110100111011011112200120001220121202122022211222111
1111020200110122100101010121221111111100111210102112102210222202101111221201111101110110111111101a111a1011111101110111111101112201121211112221100122122100122111
0011011111011111110001110111110011011101101211222111011222220112012222212011101111011111101111101a111a1011111110010111111111110221101121212011211010122012222111
1111111111111101111111010011011111101111110122202222112020102112122122121111111111011111110111011a111a1111110111111101110011112212112212101211101220201122101011
1111111110111111111100011111111111101111100120201021002121220012222110101111111011111111111110101a111a1111110101011110100011112211202211210101222121221120110101
1111011111111000111111011111111000100011010211110112112210211112221222010111111101111010111111111a122a2212112212021220212111022100101202210122001202102222201111
0101111111111111111111110010011111011010110012212221212121212201100221112101111111111111111101011a200b1111102010112011011212111221022002021222122021202111121110
0111111111111111011111110100111110011011111101011111111111101011111111110101011110011111001111011a021b2212120112211122112111111101101011122111201122021110101011
1111111011101101101110101100011011111111111111011111111111111011111111111111101111111111111111100a122b1101110101122222111121112211200012100122202022020211211111
1111111111111110111111111111111111110011111011001111111111111101111110111100110111011101111110100a111a0022011120111201020112110221120111110112110002210111022111
1111110101111111111111110101100100111110111111110110010111111111111110101111111111111111101101011a210b0110020021210120101212200021110210212011222020201211122111
1011101101111111100011110110011111111111111011111011010110111111111011111111111111011111110111111a122a2022212221211202012112111011210111222200210102122200022011
1101111001101111100110110111011111111011111011111111111111110111110111111111001111111111110101111a011a2210102121222101110211121121222210222201211222220211221111
1101001111111111110000011101101110111011110011110101111111111101111111111101110011110010100111110a211a2211012202210022001202022210102102001201101120212112002111
1111111111101111011111111101011101110101111111101101111101111111111100101111011111111011100011111a210a1012212122120012001221220102212221212210210012101021111011
1111101110111110010101101011011111110111101111011111111011111100101111101111110101010010111111111a222b1112210211011222122110021121121011011222221212121121212001
1101101011011010111011011111111111111111111011111110111111110111101111111111111110111111110111101a210b2211121011222122002010222122211001212112222212200102011001
1010011011111100011111100100111111011111111100111101101111011111111111101111110111010001011100111a102b1220211021121200102212212222011111200222122111211112221111
1101101111111111111010111011111111111111111101011111111011101111111101111111111010110111111111111a111a0111011111011212211112121222121201010222110112111210110001
1111111111111111111110011111111011111111111011011111110111010110110111111111010111110111101111111a222b1220001002122222211022222211220020222220212121100221202001
0111011111111111010111110011110101111111111111011111101011111011111011100111101000111111111110101a200a2121202012111211212221222110212222221012212221121021111111
1011111110001001111011111111101111011110011111111111111111111111111101111111011111111111111101111a122b0220221001102122121111211222112211212102021222210122222010
1111110111111011111111011111101110111111111111110101110011101101111011111101111110110111111101110a221b1220122222222221101111102000122011112122012021211222201010
0110010111101110111111110101111010111111011011011110111011101111111011111111011111111111111101111a211a0210121021111122011111020111222102120100120221010122211110
0111111101111111111111111111101011111011111101111110100011111111111110101101100001111111111101110a121a2202122111212001122201221121221102101221021121010110121111
1111001111111111010111111110111110111101010101111111111101111111010110111110111011111111111110111a200b1212200122112012122111112221110122202022211222101121122111
