13 142
27 5
116 44
81 29
87 34
93 103
72 144
90 138
105 128
68 88
1010111101010111101111110110111111111100101111111111010110111111111111110110111011111111111110001010111110111101010111011011110111101000111111101100111110111111
1111111111101111111111111111111111111111011111111011101111111001111110101110111110111111011110111010111111110110011111111111111101101111110110111111111111101111
aaaaaaaaaaaaaaaaaaaaa1011110011111011111111011111101111101111000101011111111111101111111110001010111111101111100011111011101111111000111101011010111111111101111
01111110110111101111a1111110111110111110101110101011110111111111111111111111111111111111011101101111101111111111101011111111111100101111011111111001110100101101
10011111110111111111a1011101110111111010011001111111111101111111111111111011111101111011111111111011011110001110011011010111101101111101111111111011111111011111
11111111111101111111a0101111110101111111111101111111111110011111111011011111111111111011111111111111011111100010111101101111111110111111111111101111101111101101
11111011001101111111a0100111101101111001110111110011111011111101111110110111110111111111111111111110011111111111101111101110011111111111011111101111111111111110
11110100011111111011a1111111011110100111111111110111111111111111111100110111011111111101011111111001111011101111111001101111111111100111101111111111101001111111
11111110011111011111a1010011111101101111110111111010011111101101111110111101111011110101111111111111111111011110111111100111111111110111101111110010101000110011
11000100111111111111a1111111111111011111111111101101011111011111111011111110111011111110111111111110111111111011011111111111001101111101111111111111111101111110
11111111011110111111a1111111111100111111111111111101110010111111111111111111110011111111111111111111111011111111010111110110110101111111110111100111010111111110
10111110111111110111a1111111011011011111101111111111111110101111111111111111011101101111111111111111111011101111111101101111101101011011111001111111111111111110
10111011011101111111a0111010111100110101011111111111101011110111111011001011111011100111111100110111111111111110111111111111111100111010101110111111111001111011
11111111011111101011a0111111010011111111111111011110110100101111011111111111101111111111111010111111111111111110111110101111111111110111110111101111111111111011
11110111011111111111a111111101011110101111111111111001101101111111011011101111111110111010111010111111111111101111011111aaaaaaaaaaaaaaaaaaaaaaaaaaaaaaaaaaaaaaaa
11011111111100110111a011011010111101111111111111111101011011111111111111111101111111111111111111111110111101111101111101a111111111111100111111101111011111110111
11011111111111101101a111111110111111111111101101110111111011101111110111111111111100111011111011111111110110111111011101a011110101110111111111111101111011101111
11011011111111001111a111111111110110011111111110111101111011110111111111011011111111011111110110110110111100111111111110a111111111111011011111101001101111100111
00111100111111110101a111111111100011010011011111110111111110111011011111111111111111111111111001100101111101111111010101a111111110101111111111010110111111110000
10111000011111011001a101111111110111111101111011110101110101111111010111110101101111111111101101111111110111100011111011a111111111111111001011111101110110111111
11011111111010101110a111111010111111111011111111111111111111111111110010110111111111111111111111111111111111111111011111a111111111011101111111101111101110111011
11111111101011110111a111111111111111101011000101111110111111111111101110010111111111011111111111110111111111111010110010a011111111111111111111000111111111011001
11010111111111111110a111111111110111101111101101101111011011101111110110011111111101011100011110111011111111111111111101a011111101111111111111111111111110111011
00111011101111111011a111111101110111111011111111011111111111111111111100110110001111110111111100111111111111111111010101a101111110111111111110111111111111111011
11011111110111111111a101110101111110110101111111011011111110100101111101001101111110111011100100101111111111111111111111a011010101011010101111111100011111100110
01101101011111111111a111111110111111001011101111111110101101101110000101111111111011111101111111110111011101011111111111a101101110111111110110111111011101111111
11111001111111111110a110111111101110111010111011111111111011101101111111101111110111101101111101011111111111101101111111a011110110111010111101011011101111111111
11111111110111111111a110111111111111101010011111110110111111011111110011111111111111111111111111111011111101110110111110a111111111111111111111111010001111011011
11110111011011111111a111011111010111111111101111111111111111001111101011111111111011111101111111111111111111111111101011a111111011111110111111011110111011111101
11111010111111111111a011011111011111101011111011111111111111000101111111111111111111111111111110110111111001110110111001a110111111111111111111011111110111101011
11111111111111111100a010011110111111111111010111111101111001111111011111110110111011110101111001011011110011110011111111a110111110111111111011111111111101011111
11111111111011111110a111111101010111101111000101111111110111101111101101001111011111011011010111111111111110110111101111a111011101111111111111111011111111110101
10111001111111110010a111011011111101101100111111111101010011111111111111101110101011101111011011111101111111111011111110a111101111110110111111111100111101111111
01111111110111011011a111111111010110111011101111101111111111110111110101110111111111110111111010111111111110111111111111a111111111111100111110111101111111011111
11111101110110001110a001111111111111101111101100111110111111110100111100101111101011110111111011110101111111111101111111a111110010111111111111010111011111010111
11111011111111110111a111111101111011101111011111111111011011111011111101111001011110011111111111111111110011010111101011a111101110011101111111101101111111111011
11011011010111111111a011111111110110110101111101111111111111111100111110111100011101111111111000111011111111011011111101a101101110111111111110111111001111111111
01101111111011111110a111111111111000111101010110111111111111011100111111010100111111101101101110111011101111110111100111a111111111111111111111111111100011111111
11011111110100111110a101111011111001111110111110111101111111011111111011111110011111111011101111111111011110111111111111a111111011011111111111111111110111101111
11111101111011011101a111111011111101111100100101111010111111110011011111111101111011001111011101111111111111111110101101a111111111011111101111100011111110011110
11110011101111101111a011111111111110111111010111101101101101111111111011011110111011001111111101011111101010101111010011a111011111111111110111111111111110111111
11111111111111110110a111111010111101101011111101111111101111110111111111111111110110110111101111111111011111111110111001a111111011101011110100111101011010111110
10111110110111011111a110111111111010111100111111111111111110111110111111011111111110111111111111111111111111011011111000a111111111101111011011100101101111111110
11110111111111111011a111101111101111111111111111011111111111010101011010111111101111111111101111111111101001111111110111a111011101111111110101111111110111111010
11111111111001101001a110101111111001111011011111111111011011001100101111001110111101111111111111011111111111111111111101a110101010111111101111010010111111110111
11001111000011011111a111111111111110011111111011111111111111111011111101111110111100111111111111111110111110111110110111a111001111111111111011111101110111110111
11101111111111111111a101000111011111111111110111101111111111010111101110111100111111111101110111111111011111110111011011a111011111110110111111111111101110111111
11011011111111111011a011111111101111111101110110111111111101001110111110111111101111111111111111111111110110100101111111a101111111101111110100111111101111111110
11111111111111100101a111110101111111100100011101111111111111111010111111111111101110010110111111011111111111111100011101a011111110111111011101011101110011110111
11111111111111101011a101110101111111111101111011101111101111111111111110111111101110000100011111111111111111001111011101a011111111111101111111010111111101011111
10001101101101011111a111111101111110110011111111111111111111111111111111111101111111111101111001110111111011111111111111a001111111111000011111111101001101011011
11101111111111101110a011111001101101111111101000111111101111101101011100110111101101111111001011111111111101100111111111a011111111111100111011111101011011011111
11111010111111011111a011110111111111110011111111010111111111111111111110111111110111111011111111111111011110111010111111a110100111111011111111110111111111111110
11011111011111101111a011111011100011111011110101111001111111111111110111111111101111111101011110101101111111000011011111a111111110011111011011011111111111111111
11101111111100011101a1111110111111111111011111111110101111101011111010010110111110010111001111111111aaaaaaaaaaaaaaaaaaaaa111011110111101111111111011111011111111
11101011111111111111a0101111111011111111101110111101111101110111111111111111111111110011100110001101a11101011011111011111111011100110110011110111111101011111001
00110111111111011111a1110111101101001111101111111110101101011101111111001111111110111111110011111111a01111110111111101111110101111111011111001111011101101011111
01111001100111011011a1101011111111011111101011111110111111101011011001111101101011111111011111100001a11011110011011110111111111111111111110111011111110011111111
11101110110011111011a1110100101101110100111111111011111101110001011101110110111111111111111011111101a11101101111111111111101111110101010101110110111101010110011
11111111110011111111a1101100011111111111111111111001111110111111111101111111011001111011011111110111a11101111110111111110100011101110111111100100110111111111011
11111011011101111101a1101111111011111101111110001111011110101111110111011110011111010011100111011110a11110111111011111111011111111111111011111111110111111111111
11111111011111101011a0111111111011111111011111101111111110110111111111101111111111111111111011111111a01111111111111111111101111111111111011101111111111010110111
10011101100101111111a1010100111111011111101111111110101110011100100101111111101111101011111110111111a01011101110111101001101110101100111111111110111111110110011
11111111100010110100a0111101111111111110111111011111011111111101111111111101111101101111111110111111a11111111111101111111010111001111101111111111111011111111110
00011001110111111111a1111111111111110110101111011111111111110110110111111110111111111111011111111011a11111011111111111110110001111010111111111111111111111011011
11011111111111111111a1111110101110111110110111111111111111110101111010111111111110011111001111011011a00101111111110111110111111111101111101001111111111101111111
11110111011111101111a1010111111111111111111111101111111111111111101110111011111111001011101111111111a11011111111101111101011110101100101111011111101110110111111
10111101011011111111a1111110110101010111111101111110110011011110111001101110100111111111101101101111a11111110111111111001111011111111111111110111010111111110110
11111111111011011001a0111011111111111111110110111011111101111011001110110011101011111110111122212221a12200222222202111211010101111111101111111111111011110111111
11111111011110110101a0111111101110111101111111110111111010111111001111111111111101111111121212002212a22011222120111122111101011111101111101011110111111001111011
11111011011111011111a1111111011111101101111111111101111011110011110111111111111110111111201022012112b21112002020020001211011111111110111111110111111111111011111
01111111111111100011a1010101111111111111111101111010111111000010111011100111111110111011202120010222b11120222102212201011111101011111011111110100111011111111111
11101111111111001011a1111110101111111110111110000111111011111011111110011011111111111111012221121111b12022201101111222211110001101111011111111011220221021122212
11111111110101100110a1100110011111111011110100011111111111110111111110010011111011111110011211121201b02212111212112220010110110111011111111110111222011200201211
11011111111111101101a1111100111011011011011011111111110111111111111111110111111111111011222111001022b22121210021221121211110111111010111110101010120112111022102
11011110101011101001a0111110011111111111010111011111111111101101101111111111111111101111210211002121a11112122210111111101101111111101111111101112211101211222122
11011011111111111111a1111101111011011110111011110111111001111111111111111111111011111011110211020020b11012222120222222011110111111111111111111011012121112122111
11111111101101001111a1111111111101101111111111111111101111111011111011111110111111111101210122122222a11012111201111120110111110111101111111101110201111021221100
11111011111111111111a1111101101111111110111101100110111111101111111110111111100101110111112010101121b10122201222211120111101111111011110111010010201222122110011
01110111110111111111a1001101011110101110111111001111101111011111100111111111111111111110202002110021a2202122222221baaaaaaaaaaaaaaaaaaaaaaaaaaaaaaaaababbabaaabbb
11101100010111101111a1111110010111111111111110100001111111111011111011101110011111110011101021211221b1211212212012b211111100111110000011111111112212221110211102
11111111111111001111a1110011121201220220201212022220211120211111100101101010101111111011220111220021a1011211121222b201001111111101111110101110102221102021112002
aaaaaaaaaaaaaaaaaaaaa1111110011211001021122211111211122221111111111101011111111111111111211122200222b2102222022111a212011111110110011111011111001212222221201110
1111101111111111110101111111102201202022212202221010002101220111111111011111111110111011021020122221a0110212222222a212111111011011101111110111101002110112122121
0111101111101111111111011110111211112111010122012002211201100111111110111111101111111011112201212121b2202111221122b011110111110111111111000111111201212220202020
1111101111111111111111111010122212210202222002101211201220111111101111111111101111101111222121211112a2201112002120b120211111101111001011110110011011122021111211
1111111110111011101111111111012111220110202212122221121222211111001111111010101111111111010120221221b0201211111121a010101111111011100101111111010222212221001121
1011100111111011101101011111121122111102011221122202012221101122211110111011111001111111102121212111a1012221112201a122110110111101111110111001112021212220210222
1011110111111111101110111111002212220111112211101102201200012022211111111111101111111111120121102010a2022111110221b122111110111011110111110111010111212122121211
1101111111001011111111101111121202121200022121121112112121120210011011111001011101111001110122020221b1112121122112a020101011111101101111110111002222102202221211
1111110101101110111011111111111001221222221211012201011011210222111111110110111111111111212222112212b0111220012021b021110111111011010111112122221212100200212221
1111110010110111111111111111120102120201111212111211010121210122101111111000111111011010212211101111b2000222111011b101100101110001111111112121102202222102121100
1111111101111111111011111111110022101121102221122002211112121022111111111111100110110101202202200211a1221011201121a212100001111111010111111222110111211221201122
1111111011101111111000100111121122110200122121100122111121111211111111011001111001100111221120222202b1112022112211b211121120211021222211111011222211211212111120
aaaaaaaaaaaaaaaaaaaaaaaaaaaaabaabbbbaaabaaaaabaaaaabbbbabaabababaaaaaaaaaaaaaaaaaaaaaaaabaabaaaaaaabb1122221210001b102122202121211101111102110121012022221111211
111101011101111001111101111102211202121122111221222100101112212011111110111111111111111121111210200221111112222111a020111102122210021211101012212101112011201100
101011010111110111111111101112202112121120102202122121102112211021111111111111110100011121021122211122212101211212b221120121011201120111112120101200212012011021
111101001111111111110110111111220201011021220101000201012020111201111111111100001111010001112112021220211012222002b112222112212021122201102201122112200101122202
001001111111010111111111111111101102021120211221221022211210222221110111101110101111110110011022121112000011000201b222111101122012202101010110200211222112011221
01110111110aaaaaaaaaaaaaaaaaabbababbabaaaaaaaaaaaaaaaaaaaaaaabbabaaaaaaa1111011110111101111111aaaaaaaaabaaaaaabbaaa111111011111110110111011011101111111111112021
01110111111a11111111011111011011211211121112112121221110201211122111010a1111010110001111111111a11101111211222212121122202120212222101211112121110111201211112121
01111111101a10111110111011111012211212111212212201212221021111012111111a0111101110111010101110a01111111222220122101212101122100002212201110220112112011112101220
00111111101a01111100111001111120212222120121022002121201211222220011111a0111110110010111111110a11011111222001211110122212210221001121111112201222112121211111100
11111111111a01111110111010101211122211222121202111212112111222011110011a1111111100111111011011a11111111021111112110121121120100211120001102212202101020211112211
11110011111a11111111111110111201200111120101112000210110211111121111110a1110110101011111110101a01110110221222112101101111110021201121201112220221212210112221120
11111011101a11111110111001111110222111221112111010111200221121101111110a0111111111111110111111a11110101122222202101111021122212101222011110111211120100110110100
11111110111a10111111101101100110101011101112112022210112121101121101111a1111101101111010001111a11111011111112201022022102212212220221221221112220111122111110021
01011111111a11111111111011011202201202222110212121121210101211001110111a0111111111111010101101a11110101210021212121222211101210221221121211201201101111102022211
11111111111a11110111011110111111212212212120221021122121121220121111011a1111111100001011100011a11111111211101020111221212121112110112211111111222121112210112120
11111111011a10111111111111111201112221210100122221122120001020222111111a1110111111111110011110a11101111222121110112111211112101000112211112121121210202101111110
11110111011a11111111111111111210101111122200112121102202211222102111111a1011111111111111111111a11111110211120212121022021111212122221201111111212212102111201011
10011111111a10111111111110111211012202122100211111102110201110222111011a0111011111111111011111a11111111202112221111122021121111220211110202110120222122101122111
11101111111a00010111100011111011012000020221101021222111211020211101111a1111111111111111011001a01111110112211220011222220222221121222101221212212212100210021021
11011111101a11001011110111110011111212102120222111012210220020222111111a0110101111111111111110a11111111120010222121002221110111222121221221021222211110111122211
11101111110a01110001111011001111110112111022201020000211121021201011101a1101100111001101011111a11111111120201221112221112211211212101101122121020112111211220221
11111111111a11111111111111111111111111121221102211211122221111211111111a1101101101111011111111a10101111011212111112121112101222212120021011221221221111212020210
11111011001a10111110111111111111102111212221201222021110111011211011022a1201111101111111111110a01011001012221000111202222112102110000011011112121110121012112010
10111101110a11110111110111111110110111222111112222112120100222211121212a2220000011111111111111a11101111212211122111222211211212201121111220101220212011110120221
11111111111a10101111111111111001111111111010211110212211001101002012222b1121110101110111011111a11101011101212112101122022021101220211210220112202101021012122121
10111101111a11111111011010111110111111111111112102010111111111112121112b2021011111101001001110a10111111221111221121101212002001221220221211102100012211112211200
