11 121
106 142
52 136
90 129
48 87
14 155
32 103
93 88
115 30
30 38
1110011110101011111110111001111111011100111111110111011111111010111110011110111111111001010101101111a0111111a101111111100110111111111101101110101111111111100110
1010110101111111110111111010011101111111100000110001111111011111011111100111111110111111111111101111a0111111a000111111011101001111111111011111101111110001111010
1111101011111111110111111110111110111111111110111111111111011111111110111111111111000011111100011011a0011111a111111101011111111011111111111110111111111111011100
1111101111111101111110111110001111111111111010101110011010100110111111111111110111110011011111111111a1111110a011111111111111111111111111011110111101011111111111
1111011111111111111101101110011111101011111011111111111110101111111110110111100111111111001111111001a1111111a010111111111111111011111101111011111110110111111111
0111011011111101111101110111100101011111101111111101111011101111011100110101101111111011101111111111a1100111a001101111111101101011000111101110111111111111111101
1011110111100111110101110111000011111101011111111010111110011011111111111111111111111011111111011010a0101111a1110111111aaaaaaaaaaaaaaaaaaaaaaaaaaaaaaaaaaaaaaaaa
1110101011111111111111111110111111111111111111111111011001111110111111111011111110111011111110011011a0111001a0111111011a1110011101011111111011001111111111111111
1111111111111111111011111111111101011111111011111111101000100111110101100100011111111111111110111111a1011111a0101101111a0111111111111101111011010101111110111111
1111111111111101111011111110111101111011011111110111011101111011111100001001111111111010111111101011a0111011a1100111111a1101111111111111011111111110110111100100
1110111011111110111100111111100111011011111011111111111011111110111111111110111110111111111111101011a0111111a1101111111a1110111011011110111011001111101101101111
1101010111101111101111111111111111110111111011110101111011101110100110101011111110101101111111101011a1111111a1101111101a1101111111101001101111011111111111111101
1111110111110110101111111111111001111011110111111100111111111111111001101011110111111101111110111111a1011111a1111111111a1111111111111111010111111011111110111011
0111111011111111101011111010011100011111101001111111111111111111011111111111111111011111111111111111a0111111a1111111110a1000010010111101111111101111111110111101
1101011111010111110011110111011111111111011011111101011111111101111111111110011111011101111111111011a1111011a1011011111a1111011111011111110110110101111110111222
1110111111111111111110111111011111111111110111111111111111111100101111110011111101110110111110111111a1111111a1101111111a1111111110111111111010111111101101111212
0100111000101110010111111111111111111111110110111111111011111111111111110011001111101111010111100110a1111111a1111110010a1110111111111111111110111111101011012121
0101111111110011110101111111111101101100111110011111111111111101111101110111101111101011111110011111a1111111a1111011011a0111111111111101111111111111111111112211
1111110111111101011111111101111011101110100111111111100101101111011111111111111110000111110111111011a1101101a1110100111a1110101111111010110011001110111101121112
1111111111011101111101101101011111111111110111101111111111100110011011111001111010111111100111110100a1100111a1101101111a1111011011101110111001110111111111121222
1111111101110010011111111000111011111111111111001110111101111110011011111111111111111011111111111111a1111111a1011111111a1111111111001111110110111111011111110220
0111110111111111111011110111110011010111111111111111111101110111111101111111111111011011110000111111a1111110a1011111011a1101001111111111111101100111011111012021
1111111001100111110111111110111111111101111010110101111110111111011011100100111011110101111011111111a1111111a1111011111a1011010111011110111111111001001011121111
1101111010111111111111111101011111111110111111011111100101111110111110111111110111101101110110110111a1111101a0011100110a1111011111111111111011111111110101021121
1101011111111110111111111011111101111101110111110110110011011111110111100111001111111010110111111011a1000110a1111111111a1111101111101111101111111111111011100200
1111111111110111111101101111010111110111101111111011110101111111011101111111110111111111011101111101a1101111a0011111101a1111111101111111111111010010111111112121
1111111111111111111110111111000111111111111111011111111111101111110111110111101111111111110111111111a1101111a1100011110aaaaaaaaaaaaaaaaaaaaaaaaaaaaaaaaaaaaaaaab
1111111100111101100111111110111101111010111111111011100111101111011110100111001111100110110111101111a1111011a111111111111111111111011110111111100111111111101221
1101011110111111111111111110110011010011111111011111111110101111010101100110111111111101101011011110a1111111a011111010110100111110011111101110111100111111122110
0101101111110101011011001110011111111111110111011111011111110101111111011111011111111111110100111111a1011111a111111101100100111011111111111111111011111101122111
1101111111111111010010111101111111111111121101012011112111121121222121111111111011111011111001101011a1011010a100111111010111111111001111011111101111111010111011
1110111111111111110111111110111111111122111221112111122100121022122221111010110011111110111110111111a0110111a111110111110111111101101100111111111110111111111222
1111011110111101011011101111111111101022101220222101111002201221122220111111111111111111111111111110a1111221b222000221112211112222011211011111111110110011121210
1111111111111101111111011011111111101120112211211211111222101221121211111101111101111111111011111111a1111221a012122111111120112211221011110110001111001110121021
0111111111001111111111011110111010111012111101102102001211121122021210111111110110101001111111111111a1111220a111121212110111011121011211111011111111111110021212
1111111111111101111111111110111101100122122121222211201202221121022101011101111010110111111111011110a0022102b201222112122122211022021111111111111111111111011202
1111111011111010011110111100111101111121122212122121100211210112002220110111100111111111111111100111a1111112b121120221220121020212121011110110101011111010021212
1111001011101111011111011100111111110111020121221101212212221222121201101111110100010111110111101111a1112222b121110100212212011110022010111101111111110111111021
1110111011101111011011111011101011001100001101111111111111001212012211011111111111111001111111111110a1111111a222112220210210200111122111011111111101111111011200
1011101111111101100111111111011111111012212222222121211111011100201021111010110011111111111101010111a0121111b012212011121112122001122110101111110010111110120112
1100011010110111111111111111111111111120222212102221221121110122111121011001110001111111111110111110a1001212b110122010212222220201010111110010110111101111111011
0101101001111111111111111111101011111121221211211212202221001122111121011111111111111011110101111111a1111122a222221212100222111121122110011100101111111111122122
1011101110111111110111111111011011111122220122121012122111022222111221111101101001111101111111011011a1112220b211122121022211101012011111101010011111111110112212
1110101111011111111101111101000011111122011011101222211211222111201201100111110111110111101010101111a0120120b111210222121111112221211011111111111111111011110122
1111011111111111101111011111010001111021210212211112221211200111011111111111111011111110111111111101a1002011b120220222222112220212211011110010111101111111021122
1010111111111111111101111101111011011122111001202221212202002100100111111101110111011110111001111111a1111222b011011102022220010222001211010110110111111111111101
aaaaaaaaaaaaaaaaaaaaaaaaaaaaaaaaaaaaaaaabbabbbbbbbbbaabbbbbbbbabbbaabaaaaaaaaaaaaaaaaaaaaaaaaaaaaaaaa1122101a212101102002112212102121211111100101101111111111111
111111111111101111101110001110101110111111111112221110211211112110122110111111101111011111110111110101100122a221122012112021222102211111111011111111111111100011
111111011100111101111110111111111111011102012012122002211201111121222110111111111111110102122110111211222122b221220120222120110210121011011011011111111001001101
111111101110111101111100111110111111011111110111111110111101112212201111111111111111010210222211222011020211a220212102200210111111211200110111111111100111110111
110111111111110111111111111101111111112012211011120221210121112111102111011101111111111022120112222200111121b212211122222022221202102201111011111110011110101111
101101101101110010111110100101111100011111111010011122011012122102210100111111111111110211000210222112222211a202122112200111110012202210111111001111101110110111
111011111100111111111111101111111111100010112111111122011112122220112111111111111110111201121211101211112110a112221122212211222011012210121110111111111111111010
111011111101111111101101101011111110101212211221021111110211110021110100110100101111111201221102121121022011a112212012212121001122202011121122122111121110210110
111100110111111111111011111101111101111212120112121211020022101222112101111111011100111212112011221122102121a101101210110211201102221001112022110221222221111212
101101101101111011111101111001111001110101120222100120122011102011222100011011111111011012212021122221100122a222110122102000212112012101121112121221220112021020
111111001110110111111111101110100110111112211021120211121212122200222101111111111111110022110211212221001111a211022121122201120002200211112112221102121001012220
111101111111010111111111010111111111012102211112112102201211112112111111110111111101111222020201222222022101a211102222021101021011222111001120011101221212111221
110100111101110111111101111111111011111212201120012221220011012121110111110101111111110021102101211210212002a120111122212111022211011111120001121122221211111211
101101101111111110111111111111110111112212220221221122121221111112110111011010111101101111112210211102021001a212010200002200011121112201222021222201211211121221
111111111111111101101111111111110111111011111011111110111111101101101111111111111011111111111111101111111110babbaaaabbbabababbbaa2122100221021112022211222122122
11111110011111110111111111111100110111111110111111111011111111111101111101111110111111112221211011212201220121110212120110011211a1212211222111001222111010221220
11111011110111011111110111111001111011111111111111111111111011111100001111110111111101102011011201022012211001121222112121222222b1011111011121222222221211100001
00101111111111101101110110011001110111111101111111011001011101010110010111111110011110012212212110221202202111022212221101011111a0111101201000220212022110101210
11111100101111111111110101111111101111111111101010011111111011111011101110111111111111122201020112121102022121220202111011111111a1111011211121110222110020202112
11111110011111111111011110111111011101111011111111011101001000111111111110111101111001001101010022122021111101012222211111111110a1111101211121212201012221200111
11111111111111111110110111111111111110001111111011111111111110111111111111111110111010101022012121211200001211222112210111111111a1111111100101210020100201122212
11111111111111111110101111111111111111111111111100001011010101011110100111110111111101121121020021122221111102202201121111111110a1101111111121022020012202210100
01111110111111111111111111111101111111110111111111110101101111111101110010011110111001121112211122011021212112021120121001101110a1101101122122212021202201112221
11111011110111110111111111111101101111111111111111111111111101010101001111111110111111122210222121222110112122222200101101110101a1111100221121201110202111011001
aaaaaaaaaaaaaaaaaaaaaaaaaaaaaaaaaaaaaaaaaaaaaaaaaaaaaaaaaaaaaaaaaaaaaaaaaaaaaaaaaaaaaaababbabbbababbbabaaabaabbabababaaaa1111111a1111101122111110222222120020111
101111101111111111010111101011011111111100011111111011111111101110111111111111111111101202011122112202102221010102120110a1111111a1011111111121011222121210101200
100011101111110110111111011111100111110111111111100111111111011100110111111111101111110110122201111111121221120121110111a1111011a0101111221021210220022202101120
111110111111011111111111111011101011101111111111101110111101111111111111011110111001111212210210020211011202212211211111a1010111a1111111122121211120020211212001
111111111111111111111111111111111111101111111111111001111110111110111000111101111101101222101112022011010211022221021100a1111111a1111011220122202110210002211021
111101011111111110111111011101111111111111111001111011111110111010111011111111111111011112111211222222110122101112120111a0111111a1110011220022211210201212211111
111011110111101110111111111110011111111110111111111111011111101111110111111111111011101222222221022221111221221122212201a1111011a1111110210000211222220122201120
111111111001101110111111111111101111111001111110111110101111111111111101111011111111111121022022021101211112220022112210a1110111a1011111211022112121120111212122
110101110111111111101110101111111101101011111110011110110111101111111101111111111011111202010102212022100201202012120011a0111001a1010111220120121122111002021121
111111111111111111111111111011111111111111011000111111011111111110111111111110111110100011101111111111111111111111101111a1111011a1111010101111111101111111101111
111011111111111101011101011010101011101110111010111101111110100110011111111111111011111111010011110001111101101111111111a1001111a1001111122022021111001212112100
111111111101110111010110110111111111111111111101011111101111101111011011101110111101111111111111110111111101111100100111a1111111a1111101211022211110110122221212
111111111111101111111011111110101111111011111110001011100101111110011111111011111111011111010111111011011111110111101111a1111110a1101111102121122100121112101111
111111110101110111111111111110111101110111111101110111111111111111111101101010111010101111110111111011010101101111111101a0111011a1111101010111111111111111111111
111101111111011101111111111010111110111111111111111111110110111111011111111111000111111111111101111111110110101011101111a1110111a1111111111111101110110111111101
111110111111111111111100101111111110011111111101110111101111001010110011011101111111011011111111111010111111111111101011a1111110a1111111111100011111111111111110
100011101111111111001111110111111111011111011001011111111111101101111100110111100011011010110101111111100111111111111111a1110011a0100110111111110111111111111011
111111111111110011111111011111110100011111011111111100111111111111101011101011101000101010111101111111111111111111110111a1111111a1101111111110111111010011111111
111111101111111101101111111111111110011111111111111111111111101111111111111001111111011111100110101111101110111101111111a1011111a1111101111010110010110111111111
111111101001011111110111111111111111010111010111111111111110111111101111011111111110101101111101101101101110100011001110a1110110a1111111110001001111101101101100
111101111111011111101111101111010111011011111101011010111111111011111101101111111111111010101111111110111111111111110001a1111111a1222112121101102121222212020221
111111111111111010111111111101111111111110101111111011111111111111001111111111111111111111101111111111011001111101111001a1011010a0111212211102112212022020122112
011110111111111011111111110111111111111111111111111111110111111111110100111100101110111010001101110111101101101101111111a1111110a1102122111122220222111221102020
010011111101111101101111110110111111111111111111111111111111111011110110111111110111111112111111122211020222212012222001a1111101a1101121122121022210121122212211
111110110111111111111011111110110111111011111010110111111111111111111111111111111110111102212211102010220210121220121221a0111011a1100022021121101101212021121002
110100011110101101111011111011101111111110111111110110110111111110011111111111111010111112122222011201102011002221120121a0101111a1100020120111201211212210202111
111101011111011101111111111011110011101111011110111010101111111011111111011111011011111111210211222111102211111101122111a1111011a2112211110120111020201011220102
100011111111011111111101111111101101111111110001110010101110111011011111011100111111111111201002211211002111120212201211a1001110a2022212120101222211211222111112
011101111111111011111111111001111111111111111111111111011111111011111011111111110111111111221202222112212212001121022211a1111111a2110122112112112121111220212221
101111111110111110110110101110011110011111101110111110110011111011111111111110001111100010022122220112211121022211011211a1011011a0212211221121121221021210211210
111111011111111111111111100011011111111101110111111111111011111111111111111100011111101122221022221200121002211220002001a1111111aabbbabbaababbaaabaabaababbbbbba
111110111101111001101011010111110001011110111111111111111111011111101101101110101111011102112010221200220120112000212121a101011111121111212112221111122121110110
111111110111111101111000011111111111111101111011111100111101111011111111011110111111110122112111222202112211012222221010a111101112021022222212110122100120211112
111111111111111111010101110011111111011110111110111101101011111111011111101111011101111102122201212211001212012210202220a111101112121200101122221100122221222010
101110110111111011111111101111111111111111101111110111111101110011011101011111111110110122221210021212022110120011010111a101111112112200121211011121120011011112
111101111111011111111011101011011101111111010111110101101111111110111011110101111011111122111121111011222021201222201210a111001012102122211021221120110011122112
111111101011100110111111110111011111110111111011111111111110100110111111011011110111011111010012122020122122122111212121a111111110012121022221110020122220201020
101111111111011011011101101000101001111111111111111111100111010100011111111110101101111120101201021101211211111021220211a111111100121221212221121202222021121021
111101110101101111111111111111100110110110011111111111111101111111111101111111011111011112112120210200022101211212221121a111111001110211111212120121102201121100
010111111111111011111110011111110111111111111111111110111111001111111111111011111111101122212202211211202112112200111201a011011112201112221012121112122110222201
111111110101101110111111011111111111001011111010110110111111101001100111011110111101111100122120011102202211021020222000aaaaaaaaaaabbababaaaabaaabbaababbabaabbb
1101111111111110111110110110111111101110111111111011111111111111111111110011101101101110221211120022200122222221022221111110101112011222121221120122221200220002
1101111111011010111011111111111111101111110110111111111111111111100111110111010111000111121122221121021021112122211201111111111012111220212101220212000221112220
1111100101111011111111111111111111111111011110111101101111111111110111011001011111111111222021221202211111221112211012211110011110222201212111111222121010210002
1111111101110101111111111101111111111001111110111111111111011111111101111111111111111101111100222222212211020122221011111111111110212111201011222111111002111201
0011110110110011111011111101012111101112120111211221121121101111011111111111001111111110122120121221011122022212102111111011011111011210020122002122202112122122
1110011111111101111111101111112222202100111212202111221121011011111101111110011110101011021201222011122211120201220112211111111112112212202201112110202121021211
0111100111100111111011011111111020120200021222001122011121212011111111101111011111100011101111210112201211212211222212211111111112021211210011121221000011121221
1011111011011100111100011101012101121022112102221112121111000111111111111111111111011111211111111221120212121222102121011011111001212112211221211121221021011100
1011111110111111111011111101100101212101020022222001222011112111110111111111011111111011221222121210121022011210221111011110111112020020101010110011111001111111
