46 5
102 115
11 33
86 39
76 48
35 143
80 29
73 30
114 91
62 66
1100111111011010111001111011111111111111111111111111111101111111101111101111111011111101001010011101111011111110110111101101111110110111111010011011101110111111
1010110111111111111011111111110111111011011110111111110111111111001110100111101001111111111111111111101110110011101110011011111111111011011111101110111111111111
1101111111100111111011100110100111110011110001111110111110111011111110111111111111010100111011101111111111110111111111111111010111101111110001111011111111110111
1111110111101100111111010111101111111111101111011110110111111000111111101111111010111110100011011111011111111101000111111111101011111011000111111110111111111101
1101111111010111011011111111111111011110111111111111010111111111111111111111001111010110101101101011101011111111111001111111001111110111011111111111111010111101
1110111101011111101111110111111111011011011110111111111110111110111110111111001111101001111111111111101100111011111111110111111110111011001110111111111111011100
1110001110111111101111111001111000111111111110111111111011111111101111011001111101101110111111111111110110111110011111011011111111111111111001101111110111111111
1111100010111101111101111111111111001001100111111011101111111101101010111111110111101110101111011001101011101110111111011111110111111111011110011111010011110011
1110011011111111111101101111011111111011111111111011111111100101001101101101110101011111110110110110010101100011101110111011111101111111101101101001111111011011
1111111111101101111011001011101110111101110110111111111111111011111111111111011110111100111111111101111111100110111110111111111010111011111111110100100111111111
1111110010110101111111101111011010000110001111111111111111111011111111101101101111111111111111101111101101111110111111111111111111011011111111011101110111111101
1110011101111111101111011111111110112201112112112210021222112221111101011101111111111111111111111101111101111111111011110111111101111001100011011111111111101111
1111111111111101110101110111111100210220121111121211112201020102111111011111111111011111111011111010111111111111110111110111110111111001101110111111110111111111
1111110101111111111111011111111112202022111101000121112022110022110111111011111011111111010111111110110101111111111111111111011011111111111111101111111110111100
1110111111111111111110111101110112122220111212112012211121221222011111101101111111111111111011001011100011111111100010101011111101111111111111111111011011111111
1111111110011011111111111010110112121211010111022221110202202122111100110100111101111110111111111011110111111111101100011111101101110111101111110111101111111111
1111110111111111111111111111011110012221101212210221121122100122111111111110111111000111111011101111111111111110011011111111110111011111011111001011110111111111
0111111010111111011011111111111012112222121210211102110122222212111111110111111010111101111011110110111011101110101110111101111111111111111111111110111011111111
1110111011111111111111111111111011120211111101220000111210211201100111111111111111011111111111110011111111111111111111111100111111010101011011111101011111101111
0111011111110101111000101111111112021122101001212110201222002212111111110101111111101110111111011101111111111101111101111011111111110110011111100111101111011111
1100111101110111111111111111101111212222122211122222211010121220111111111110010111111011111010011110111001011111111111111111111111111111111000111101111111110111
1111111111101111111111101111111010221222022211212121121110110011100111111011011111011111101111111110110111111111111001110111111110111111111111111110110111110111
1111100101010111111011111011111102222122121222121121012102200121111111111011011011111111111110011111110111010111101011101111011111111101111100011110110110101110
1111111110111111111101011111111011222101122010122110120212111220011111001111111111111011110111111111101111111111111011111111111111111111111111010110111110111111
1011110011111111101001111111011111222112111222221221122112102222111111111011110110111111011111011001111111110111111011111011111101111111101111111111111111011111
aaaaaaaaaaaaaaaaaaaaaaaaaaaaaaaaaabbaabbababbabaaaaaabaabbaababbaaaaaaaaaaaaaaaaaaaaaaaaaaaaaaaaaaaaaaaaaaaaaaaaaaaaaaaaaaaaaaaaaaaaaaaaaaaaaaaaaaaaaaaaaaaaaaaa
1110111111011111101111111111111111121120121211121220222111011202111111110111111111110100111011111011111111111111111111101010111111111011100100111111111110110100
1110111110111000001011011111110011201121122111210222111112202121110110111110011011101110111111111101111111111111111111110111111111111111111111101111100011011111
1111110111011101110110111110101111001111121121111202210220122211101110111111101110110111111111111101111111101011010111011111011111111111011110111110111111111111
1111111111011011101110111110111011221102111001210221222122210222110111011101111111110011010111101111101111111111110111111100111111010110110111011111011111101110
1011111011111111111011100010100002211112011020211122022022011022110111111111111111001111111111111011111110010111111111101111010110111101111111010111111101101101
1111111111101110011111011111111112221222122012121022012112020222110101110011111110111111111111101111111111011111101101110111001101011111011011010111111111111111
1111111110111110010111111111111111111011101202121121220121122011110011110111101011101011011111100111111111111111101111111110101111111110011011111011111111111111
0111110011011111011110111110101101202121112120110011122001111102011111011111111111111111101011110011010110111111011111111111101101001111111111111111001111111011
1111111111111101111011011101111112012121211111211102121222120002011011111101111111111111001111011111100010111010110111111111111110111111100100011101011111110111
1111111101011111111001111111111102110002221222210112112111101221100111111011111011011111011111111101011110111101111111111111111011111101101111021121211222222021
1111111100011111011100100111101112122212220201021212202011211111111111111111111111111111111011101111110111011111111101111111011110101111111011111222202212121222
1111111111110110111101101000111012022112012021222022021112212211111111111111111aaaaaaaaaaaaaaaaaaaaaaaaaaaaaaaaaaaaaaaaaaaaaaaaaaaaaaaaaaaaaaaababaabbabbbaaaaba
1111111111111011101101111011111111221112120002211122202110011222101001011011111a11111110011111111011111110110011001111011010111111101011111110110101112011111110
1011101110111111111011001101111100012102211122011112222222011222101110111111111a10111001111111101011100111111111110011110100111011110110001111111111100111110111
1111111111110111100011111111111102000212221221222021211012100222111111111111101a10100110111101011101111111111111101111111111111101111001111111122101101222122210
1111111111110111101111101101111112220212110212222101201221221222011101111110011a11111101101100111111101111111111110111111001111011111111111111122221112211102222
1111111011111011101111011111100111111101011111010111011111101100111111111101110a11111111110111111111110111101011111111111011111111111011110011012002211220110221
1111111111010111111110101011110110110111101010111011111111011111111111101110111a11110111001110100001111111111111001111111111111111011111110111111122002211211120
1111010101111101111000111001111011000111011111101111101111111111100101111111111a11111011111111011010011111111101111001111111111111011101011001111120111022122211
1001111101111101111010111111110001111111111101111111101111111111001110111110111a11111110101111111101101111111101111101111111111111111111111101121111210211220212
1111111111111101111111100111111101111111111111111110111111111111010011011111111a01111111111110111111111111110111101111111100010111111111111011021122012201101221
1111101111111111001011101001111111101111111111011111101011101011111111011111110a11111111111111111110110111011111111111111111111111101111111111121112012111101110
1110111001111001101111111111111011101111111111111111101111111101101111111111011a11001011111101111111111110101111101111011111111101101111111111001110101212211122
1111110101101011101011111111111111010111110111111101111111111101111000000011111a11111011111110111111110001001101111111101011111011111110111111102211201201221112
1111101101011111011011101110011111111110101001111111101101011111101101111101101a11111101111011111110101101111110111101111110110111110011111111021101212210112220
1001111111101011101111001111111111111111111011111111111111111101111101011111001a11111111110111111111111111100001011111011111101110111000111011120011220212021222
1111111101111111111111111111111111101111111111101011001111110111000111110111111a11100001011111111111101010110111111100110110111111111110101101011222022112001211
1110111111111010111111011111111111011111110111111111101111111111011001111010011a11111110110001110011111110011110001001110101111111101111111101112110012111222221
1111101011111001111000111111110111001111111101010111111001111010100111101110110a11111110111111111110110111111111011111101111111101110110011111111211112120222201
1111111101111111111110111111101110111111110101000111101111110110010011110111111a01011111111111011111111110111111101111011110101010111111111111120112212112202021
0101111110101110011110110111100101111111111111010111101011111101100111101111010a111111011111111111111111110111110101110aaaaaaaaaaaaaaaaaaaaa10121011121121021112
1111111111100111111100110101111010100101111111111001111111111111111000101111111a000111011111101011101111011110011110111a1010111110111011110a11121202220221011222
0111110000011111111011111111111111111111101111011101101111011011111111111111111a111011111111111011111111111101111111111a1000101111111111100a11111202211112121101
1110111111111101111111111111111111011111011110111110011111110111111111101111111a111110110011100110111111111111111111111a1111111111111011111a11102121200122201112
0111011111111101110101011001110111111111111111110111111111111111101100111111111a111111010111111101111110111111100101111a1101101110111111011a11011121211020112121
1001111011111001111111011011111011111111111110111111111101100111111111111111100a111101111111011011110111111111111101000a1011111100111111111a11121121211211221110
1011111101111111111111011111011111101100011111100110111111011011111120221111221a022111022011212111111011101111101111101a1110111111111011111a11121110222100000210
1011111111111110111111010111100111011101010111111011111111111011101111222120221b102212022021121120111111111111111101101a1111011101111111111a11121221221111221212
1110111111101111110111111011111110001011101111111111011101101111112221121020221b011112110222212101111101110110111101111a0111111111011101101a11120112120221012011
1111111110101110101111111111111111110111011111101111111111111101111112100120220b102111221201221111111111111011111111001a1110111111100111110a10001110110101100101
1111111010101111111110011111000011111111111111111111111100101110011221102202121a012221121200100211101111110101110111011a1111111101011101111a11011101010110111111
0111111110010110110111110111111110111111111110111111111111110111112121211210112a122121101201122100111100011111111011001a1111111110111010111a01111011111111100111
1010011011110111111101011111111111111110111111111111111111111111111112222101111b222122211121202221110001101100101111110a1110111110110111111a11011111111111111111
1111110111111011111101001111111111111111101010111111101111100111102211112211211b020110110012211001101111111111101111110a1111111011111111111a11011111111110001101
1001111111111101111110011111100110101101111111010011111111111111100211011101022a211001121122001111111110011111111101111a1111011110101111111a10101101110001101111
1111110111111101101110111111111011010110101111110111011110111111111101001021121a021112220212022021111001111011111111111a1111111111101111101a11101011111011100111
1110111110111101111111110011111111010010111111111111111111111001111112111222102a010012122121011121110011111001011011111a1111001101110111111a11111011101111011101
0011101110011011111011110111110001202201022221200221222102110111012222101112202b111212202111101121101111111111011101111a1110011111101101111a01011101111111011111
1111101110111111101101010010112222020212122100022112112111222111112222222212120a120220122112102121010111110111100001111a0110101111111111111a11101101111111111110
1101111111111111010111101111112101211001111002000221010101201111111212122110010a111121112120222221011011101011111111100a1111111111111101111a01111111101101111111
1101001110101100111111111101111212121022201001222111222102111022212112221100021a0112110111211201111aaaaaaaaaaaaaaaaaaaaa1111110111111111110a10111111011111111110
1101110111111111111110111101102212211221110021102120210122112201222111012110211b1120110201012220111a100111110001001111101110111101111100010a00101101111111111111
1111110111111101110111001101011112212122110211121110000012122021021011212121211b1200200112221202101a011111101111100111011111111111001111110a11101111111111111011
11010101110aaaaaaaaaaaaaaaaaaaaaaaaaaaaaaaaababbbbbbaabbabbbbbbabbaaaaab1210202a2112221120111022211a111011000111111110111101101111111110111a11111111111110100111
11011111111a11111110111011110100222021011212112211020010122122220122022b2122110a0102121111121011211a110101110100101011111111111111111111111a11111111111001011101
11101010111a01111111110111010111022221122111111101212212222120011120112b0120212a0021022122222222211a111110111101101110110111111100111111111a11011111101111111110
10101100001a01011111111111101112212212111212100211112112122121102212120b1112211a1011122211122221210a011111011111101011111111101011111111111a01111111111111011001
11111101111a11000111101011111212111112112101120112221210112220211221002b2111022a1222122202221211211a111011011110111111111111111111101111111a10011101111111111011
11111011111a01111111011000111121111112221012201111212021120212002120012b2121210b2022221201212011211a111011111111001110011100101011101111111a10101111111111010111
11111111010a11111011011111111211122111122100210122112211200001110212111a1020112b1022222221221121101a111111111111111111010110111111111111111a11111110111110110111
11001111111a11111011111111111110121222020111101121211011111021201112201a1022202a2110112001111021211a111111111111111010111111111111111111011a11101111111011111111
10101111111a11111111111001011202101221201112200211002012101211112011210a2011120a1110222211111120111a101111011111000010110101111111111110110a01110111011101010110
11111111111a11101111110110111001211220201211111122110121111111110020201a2001210a0111212022201011011a011101101110111111111111011111111111111a11110111111111111111
11011111111a11111110011111111221212022120211221110210211121212111111211b1202211b2011200121212102111a111111101110011111101111111111111111011a11110110101111111011
11111111101a01001111101101110111212221120002112112212122011222211210221b1110111b2101211102211101201a111111101101110101111101111111101111111a11111111111100111111
11111110111a11111101111111111222111100002011101202100212111201222100011a1211002b2112121012221112001a111110010111101110111111101001111101111a10011011111010110010
11111111111a11111010011100111222122120122112102001211221220212220120112b1100101b2102122102222111200a111110111011111111001111111101111111011a11101111111101111111
00111111111a01111110110111111102010221211110002212122212212010222212112b2122121a0011111111111101111a111101101111101011111011111111111111111a00110100110111111101
11011111101a11111010111111101210012221202111012202210112200022222221202b2122212a1111111001101111111a111101011101110101101101011001111011111a01111111111101111111
10110110111a11110111111111101122012122201210220210122122222222021012100a1110221a1011111101111111111a111111011101011111010101101110100010100a11101111101101111111
11111111110a01110111111111111011212111001212200002112111122202122022121b2002121a1111000001101111111a101101010011111111111111111011111111111a11100111111111111111
11111111111a11011111111111111011220122021212100112011212202200201211212b2101220a1111111100111101111a100111111111101100001110111111111111111a01111110111101101110
01011111111a11101111111111111022012212212111211212111221022122211102201b2112120a1111100111111111111a010101011011010101111111110111111111111a01010111110111011111
11010111111a01110011111110111112202021221011222112012121221210211210121b2211121a1111011111111111111a001101111111111011111011111010111111101a01011111110011111111
11111101111a01101010011111011220121020210110111111210002112120101210211b1200120a1111101011011111110a011111111111111100101101110111101111110a11111111111111101111
10111111111a11101101011111111112002112022210112211221202100021212210121a1212212a1110111101111110111a011001110111111111110111001111011010011a11111001111011111111
01111011101a11111111011110111102210022011111122122101022112221210112122a1121212a1110101111111111111a110111111011111111101110111111011110010a11111110111101011111
11111111101a11110111111101111220202222210102110012211220121110102020012a2202120a1101100010101111101a110111011111011101001111101111011110101a11111111001111111111
11111101010a11111111011111111112110112202111121112122201112211100011122b1111001a1011111111110111111a111010111110111111111111011111111100010a11111110111101111111
11011011001a11111001010111011111002201122212111201210222021111210221212b2111112a1111111111111111111a111111101111101101111011111011111111111a11110011001110101111
11111111101a10110111110111111111022021111011222211201220202211212202021b2222110a0011000101111111011a011111111110111111110111111111011000110a11110101111111001111
10111111111a11001101101101111222200121101201200222120112112121110112021a0011111a1101101111111001111a111111111111101101111111001111111111011a11110011011101111011
10111111111a11111111111111111210102211222011101011222220212211111112211a1111111a1001010011111111110a111111111111111101011111011011111011100a11111011111111011110
11111111111a11001110110111111110112111120110022212011201201011120211210a1111110a0111011111111011101a111111111011101110111111111111011011111a11111101101111011111
01111111111a11111111111011111222100121221011120202202111102112211222220a1110111a1111111111110111111a011101111111111111111011101101111111100a11010111111011111101
10111101111a00111110111110110111111111101112222111210102122211202222121a1011011a1111111011111111111a011101011111100111110011110111001100111a11111101101111111010
01111101111a01101111111011111111101111012112102111122022222021212111021a1111001a0111111101111111111a111111011011111111111111111111111110111a01111101111110011111
11101111111a11101111101111111111111111122211122201111122212112102221011a1111011a1110111111101110011a111011111111111011101101111111110111011a11011101110010101111
01111111010a01101101111101111111111011111101121222121221120212220011101a1011111a1000111010112222221b101110111212201210221111111111111011100a01111111110101011111
11101111110a11011111111001101111011111022211201212111112121222212210021a0011111a0011111110101022011a111102010121221210210211110110111110111a01101111111110111111
11111000111a11111111111111111111111011120111212122211110212222121221220a1111111a1111100011010221020a112210102202211221121211111111111111111aaaaaaaaaaaaaaaaaaaaa
11101111111a10110111111011111111111111111100111011101101001101010111111a1011110a1011111111010201111a202022121211022201122101011011011111011111111111011111111111
11110111110a11110010001111111111111110101111111110111011011111101111111a1111110a1111110110111101111b102102110202122112102210111101111111111110111110111111111111
11101111110a11111110111111111101111001011011110010111110111100111111101a1110111a1111111101101100111a112212101120222201201111111111101101001101111111111101110111
