59 18
62 147
16 94
29 133
18 133
79 119
104 101
100 49
22 124
76 41
110111110111111011110011111111111001111010111011101001111011a111111100111101a10011011111101111111101111111111111111111011111111111011101111111111101111011011101
111111110111111110001110110111111111111111110111111111011111a101111110111111a11010111101111111101001111111001111111110101111101111110111111110100110101111111111
111011111111111110100101111111111011101111010011111011011111a101111111101111a10011111011111111101011111110111101111101111101011101111111111110011010011111011111
111011101011100111111111111101101011111100100110111100111111a110010111111111a11111111011110111111101101011111111010111111101111001011111110100101111111011011110
111111111111011111111111111101011100011011111111111111111001a111111011011111a11111111111111011110110111111111111111101111111111111110111011011111111111111111111
111101111111101111111101111111011101101110011001111011111111a111001111010111a11111010111111111111111111011101111111001110111111110011110110111111011111111111111
111110011111000111111111111111110001110100110111111101111111a111101111111111a11110111001001110110111111111101111101111101111111111100111101111010101111001111101
111111011001111011111010111111111111110011100101111101111111a010010111111110a01111101111011111101111111111100111101111011111111111101111101011111111100111011011
11111101111101011101aaaaaaaaaaaaaaaaaaaaa0110101010010111100a111011111111001a11111101111111111110011111010111010111110111111110111101110110111111111011101011110
11111111011001111111a1111111100111111101a1111111111001110111a110111111101111a11011111111111110101111110111000111111101110011101111101011011111111111111111011110
11111110111111111110a1111101110111111011a1101101111011111011a111101111111110a01110011001111111111111110111111001110110111111101111111111001111111101111111111101
11111111111111011100a0111111111111110111a1011011111111111111a001111011111111a11011111111111110101111111011111111111011110100110111111111111001111111111111110111
11101101010111111011a1111111110101101011a0011011111101110101a111110111111111a11011111011111101110111110111111110101011101111110110111111111011111110011111111111
01111111110011111111a1111110111111101101a1111111110111101111a111111111110011a00111111110111110111111110111111101011111110001111111110111000111111111111111111101
10011111110111111001a1110111101010110111a1011111111111111110a111111111111110a11111110101101111110111111111111111110111110110011101100101011011100111111101111011
10111110011011111110a1111111110110111111a1111111100111111111a101110111101101a01111110111000111111000111011111011000111101111011111111111110111110111011111101101
01100111011001111111a1110111111111011101a1111110111111111111a111111111111111a11111111101110011212222122122210012110222122121011110111001111011101110111111110111
11111111111111111110a1111111111111111010a1111111111011111110a011111111111111a11011111111111111111011120011120112122222222111001111111111111111111111111011111110
10011111111101111101a0111100111101110111a1111111011011111111a101111111101111a11001111111101111112100222002021121212001112012111111110120120011210211221011210102
01111111111011111111a1101110011111111011a1111011011011011101a111101011111011a11101111111111111222001221212212110011101211221111011111211012211101101121001102112
11101110111111111101a1111111101111110101a0110111111110101101a111101111111111a11010111111110111211001111101100011111011011111111111111001111101111101110101111111
11111111101111111111a1101101111111111001a1111111101110111011a111111101011101a11111110111101100111101022001112112222100210122111110011110202121221110012112212221
11100111110111101110a1011111111111110010a0111110011111111111a111011111111111a00111111111111111121122220122212210012222111122201112011211012212122002122022002211
11111100110111111111a1111111010111101011a1111111111101111101a111000001011011a11111111110000001211112221110112011122110122121202012120112222212222221020222001212
11101111111111101001a1111111111111110111a1111111111111111011a011010111111111a11101011111111111110111011202000211220212001201121101020121020210121012121210212210
11110110101111111111a0111111111101111111a1011100111001111110a011111111111111a11011101111111010101120201012202111220200202211110111221102102112212221221222111112
10111111011111111111a0110001010111101110a1111011111111011110a111101111110011a10011111110111111201022021120101211011212112220011112212100122211001012112102212001
11100011011111101100a1011111000111110111a1101101011111111111a111111111011111a01111111111111110221011122102210112121111221222200102012120221101212202022220121111
11000110101110111111a1111011101010111110aaaaaaaaaaaaaaaaaaaaa101111111011110a01110110111011111121110201212102201221111222221221012122112100101212211211111112202
11111111110111011011a1111011111111101101011111011111010101111111101101111111a11111001111011110101112101220212110212200221222221121111212121212010210212211112020
11010011111111111111a1011110111111111111111111111111111111011001101110111110a11001101111111111221100101021121111111221221121021221111220121122211221222210121021
11011111111111100110a1100001110111111100110111110101101111111111101010111101a01111011111111110120022221100220212212010200212100122212222122011210101210112012121
11111111111111111011a0110111111111111101011111110110111100110111011110111010a11111101111011101021101202001122111111100211222011021110221211110221121111202012102
11101111111111101111a1011011111111100101011111101111001101111011110101110101a01001110111101110111121022112121112022212012121211121002112120220112112211111221011
00110111011111111111a1010110111011111101111111000011111101101111101111101111a10111111111011101111022102202021211211022211001011110120210212110121222101122100121
11111101111101111111a1110101111111111111011011101011111110011011000100011101a11101101111111111211100210112111210212122002201210220112111012101012101121101101020
11101111110111111100a1010111110111010110111111111111100111100001110111111000a10111101101101011211210111101221012221111222222222210201111212122111212112210201212
11000011111010111111a1111111100111111111111111011111111111110111111111011101a11111111011111011221122222111120111101122212222201221222201202221212102222021020222
00111011111111111111a1101110011100110111010111111111101111111111110111100111a01110101111110111201221112112011212121121202102111022111212121022121211211221210001
01011111110110111001a0111110111111111111011111110111111111110110111111011101a1aaaaaaaaaaaaaaaababbbaaabaaaabababbababbbbbbbbbaaabbabaaaabaa101111011011011011212
01111110100110011111a1011111111101011111101111111111111110111110101111111101a1a10100110110101122101022000011220110011012221222020001011111a222222021121211010222
11111111011111111111a1011110011111011011111111111111111101111110111111110111a1a10101111111111111101211121212011201111102021212222220122222b111121122112020122221
10011111111011011011a1111110111111101011110111111111111111011111011011010111a0a00101110111111112222112111111212011101120212121222212100202a012200112202211212122
11011111111011111111a1111011111111111111011111111110111110110010101111101101a1a11111110111111101122101202212111202221110022012212200112110b121211211110121112201
11000110110111100111a1111111111111111111110101100111101111111111001111101111a1a11101111110101110220110211122012211101111111220211212121122a221221121212221112002
01111011101111111001a1001001111011110111110111111011111111111011111111100101a1a01111111111101022111100212021211212200201202222101111112100b222222121111221211112
01111101111101111111a1001111111001101111111111110111011101011101111111011111a1a10011110111001111212212121212111212021111101210112222102121a101112221102001202120
11011111011111111100a1110111111110111111111111111110111111011111011100111001a1a11111111110111111111001111111110111111001111102202222102210b222202212011221010002
aaaaaaaaaaaaaaaaaaaaa1111111111111101111111111111101011111111110101110111010a1a11110010111111111111100111111111011111111111111210010101112a212002210100221020002
1111101111111101111110011111011111111010111111101111010100001111101111010111a1a11110110100011111111011111110101111101101111121122221102022a102110121212111122222
1111110111110110110111111111100111011111011111011111111111111111011100111100a1a01001101111110111110111111110100001100111110112121220201221a100022021110111212021
1111111101111111111111011110111111111011110110111111111101001111101011101101a1a01101110111111011110111001111111111110111111110220112111121a112121012200011220202
1110101111111111111111100111111110111101101101111011111111111101111111011101a1a11111111110101111111110111011111110101111111112212002201221b101211122112111112011
0101101101111101101111111111111111111111111111111110101111110010111111101111a1a11111011111111111001111101111101111111111111011111111112010b221111222102211121212
1111111100111110011111111110111011111101101111111111111011101101111111111101a1a11111011110011011011111111111110111111111000101110111112221a101202212012221212112
1101110110111111111110110111001111111110111111011111111110011111011011010011a1a11111011011111111111101011011110110010111011110011111111122b202121220111221020210
1111111001101111001111111011010111111110111111111011111011111111010111111111a1a11111011100111111111110111111111111011111011110111110101102a011010021121101111212
1111111001111111111011111011111111111011111110011111101101111100111111110101a0a01101110111011000011100111011110111011101110101101111012112a110222112220011211022
0011110111111110111111111111111111111111111110111011101111111100010110111111a1a01111111101011011111101110011010011111110011111111011102211a212222111001110101021
0101111111101111101110011111101111101101110111111110011110101111100111001111a1a011111111110111101111111111111110111111aaaaaaaaaaaaaaaaaaaab122220220000101112110
1110111111010011111111111111100111011101111111111110101111101111110011011111a1a101111011000110101111111110111111111111a11111111111111011011111111111110111001111
0111110111011111101111011111111111111110111111101110101011100111101111011101a1a101101101111011011110101111111011111011a10111011111111101010111011111101000101101
1111110111111111111111111111111111101011111111111101111111100110010111111101a1a111111101111110011111111101101111011011a10110101010111110011111111111111011011111
1110100111001101111110101101111111111111110110111111011101111111110111111111a1a101111110111111111001111011111111101111a11101011111111111111011111111111011111110
1011111111010111111000111111111111101010011111111001111011111101110111110111a1a001111110111111111111110111011111100111a11111011011011010011111111011111111101111
1111111111111111111011111110111111001101011111111111011111110111011110011111a1a111111100100111111110111011111011111111a01010110111110111111111111110111011101111
1101100111110110111111111101101111110101111111111111111111111111110100111111a1a011111111111110010111111111111011100101a10011100110110111111111111111100111101111
1111111011011111111111101111111111101110111111111111111111111110111111011111a1a111011111111101111110111111111101110111a10111111110111111111111111011111011001111
1111111111100111011011011111111111101111111110101110111111011010101101111111a1a010111111111001111100101010111111101111a01010011011111001101111111111111110111111
1111010111011010001111111001101111111110111011111101101110111111111111011110a1a111111110101101011111111101111111110011a11111111111010011111111111111111110111111
1110101111111111111110111111010111010111111111111111011111111110001111011111a1a111101111101011110111011111001111101111a11111110011110111111111111011101011100111
0111101001111101110111111100100110111101111111111111101111111011101111011111a1a111111101111111101111111110011111101111a11110111110101111011101111111110011111111
1111001100101111101101111101111001111111111111101011011001101111111011110110a1a110110100111101111110111010111011001111a11101111101111111011011011111111101111110
1101011111111111101111111101011011111101011111011111111111111101111111111010a1a111111111111010111111101111111111111111a11111111111101011111101111011101111111111
1111111111110111111111111011111111111111100001100101001101111101111111111011a1a111011111111101111110110111111111111111a11111101111010110111111111010011111011110
1101111111011110110111111111011111101011100001111011111111111111111111101111a1a111111111011101101110111111011101010111a11111111100101111011011111011011111100101
1011111010110111101110000110111101111110121221111211222211001112200222210010a0a110111111111111111111111111111101110111a10111111110111110101111111111111111111110
1101001111111111011011111010011111111111021110202210122010202221210111121011a0a101111111111110111011111101111101101100a11111111111101111111101111111101011111111
1111011111110011111111111110100111111111111210012112100121220122121222121110a1a111011001111111101111111111110011110111a01001100101011111111111011101111111101011
1011111111011111101101101011111111101111111111111001111111011101100101111111a1a111111101111110101111111110111011111111a0111121210bbaaabaaabbbababbbaaa1111111110
1111101110111111110111111111011101111111021212111111111121221211112112111011a0a111111111110101110011111111111111110010a1112011122b1110212221222221211a1001111000
1010111100111110110111101011111110111111101001220220111221111101121012211110a1a111111111111111111111111111111101111111a1110011212a0011122121111120001b1110111111
1111101101110111000111111111111111101001111221212011201102201121102122111110a1a111101101111101110111110101001110110111a2010212021b2121022002221110111b1111010011
1011111101001111111111111111101011111111011102211202122122212111202211111111a1a011111111110110111111111111110110111111a2112221022b0021020102000121211b1101000110
1010011110111011110111111111111100101111001211221120212212211121101122011111a1a110111111110111101111111111111001011111a1111012221a1121221002112221111b1111110111
0110011111110110011111110111111111111111111120111210221111211112200111210101a1a110011111101010111110111111111111111110a0112112112a2121212011022022200b1111111101
1111101111110111110101111111000011111101010022221110111221112100121011211111a1a011111011110111111111101011111111111111a1102111112a0121201221012222111a0111111011
1111111011111111010111010101010111000011121221010221002111222121122211211101a1a111111111101111111111111111010111111111a1102221112b1120122222222221011a1111100011
1111111110100111101101101111111110111111111021122112122211111222210221010111a1a111011110111101110111111010101111111111a2012211111b2101211110211122001a1111111111
1111011001101011111110101011010101101110121220211112021222002022202202110111a0a110010110111101111110111100111111111111a2012212012a2121021220210121111a1111111110
1101111110110011011111111110111010110001121111222122021012122012112212211001a1a110111111111110111111110111101011110111a2112211222a2020120210222021201b1111001111
1101111111101011110111100110101101111101110011111011022121210112201100211111a1a111100001111110110111111111111010111101a1110110101a2121222120010122111a0111001111
0111111111111111111111111111100111111110111212120222102121012111112012201111a1a111111101111111111111111101111011111000a1112212110b2111221211221112001b1111011111
1111011111110111111010111111011111111101121010001221211221222211122121211001a1a111111111111011001111111111101101111101a1012000120b2001212211002011111b1011001111
1111111111111101111011111010111111101110101212022112012220221112210022211101a1a101111111111101111111111111111111110011a2011221110b0121122222101110111b1111011111
1111111011111111110111111111011011111011111220010112122122122201222111010011a1a111110101111111111110111011111110101101a2111201021a2111201202122022101a0110111011
1111011111111111111111111111111111011011121112011011221121022222102100210011a0a101011111111110111101010111111011111001a2110111121a1021020122111101111a1111101111
1111101101110111101111111111111111011111111221111010210110200222211122011111a1a111111100010101011111111101111011111111a1112112221b2111120120122221111b1101000111
1101101111111111110111100111111111111011111122221222221200122020202022211001a1a101100111111111101111111101011111101011a1112122010b0120221210010022101a1111101011
1111011111111011101101111111111100010110121221210202212122221122111222201111a0a111111111111111111110111111111111110011a0111111111a1011111111111111111a1111111111
011111111011111100110011110101100001aaaaabaaaaaaaaaaaaaaaaaaaaaaaaaaaaaaaaaaa1b201101101111111111111101111101111111110a1100221122b2221212102100021101a0011111111
111111110101111111111101111111101010a11111212001120002221122011122202222110112a201011011111111111110011000111111111111a2111221222a2011221211222221100a1111111101
011111101111011110100111110011111111a11111212102001120022120210201201121202111a211110101110101111010111111111111011111a2111120201a2221221102112101111b1111111111
110011111111111101101111111111111111a00010212121111212212122221111221220101222a011111111011111111110101111110111111111a2001222010b2211122212221211100b1111001111
111110111111111111101111011111011111a10101211112111212122211121221021222221220b111111011111110011111022021211111121211a0011112120a2121220111200202111a1111101111
111110111111111001110100111111111011a11111211221111121102121221201222222202211a211111101111101110100112122120222121121a1011100121a1021222102112212001b1111111111
011011111110101110101111011111110111a10112011220021222220022120011112021210121b211001111111110111111111120122211212001b2011121202a1111201210222111110a1110101111
111111111110110011101111111110110111a11100111101121112122200111022120211112221b211111101111011111010111222011122122211b2011222220a1211000020221222110b1111110111
111111011111011110110011111001111011a10111111101121221212222221102022110212122a111111111011110111111110211012112212121b2110201221b2101221102211102111b1111111111
111111101111011111111011111111101101a01101011111120102002222121022200110112210a111111011111101111111111122011002221011a1111121202b0210110101002222111b1111111111
111111111011111111101110111111100111a11111110111101121222220211221122110221221b101011101011111111111120222112110101020b2111102220a2001111011111111111a1101111111
011111111011110001111111101111111111a11111111111121222212211211022221022202220b201111110011111111101001211222121122010a1111122111b2200111001111111011a1101111111
111111111101100101111101111110110111a11111101111111221120221110101222101120211a011111111111111100001121111021000210111a2101112111a1111000110111111011a1001111011
001101001111111111111111111110110110a11110011010111012202221221211110120222122a201111111011111111111100212112120111111a2110212121b1011111111111111111a1111010111
111101111011111111111001110111001101a11101111111121101221121211121020212212112b101010100001111111111101202122120021001b1111112221b2210111111111111111a1011111100
111100011111011011111011011111111010a11101101111101112201201111122012212211202b111101111001111111101111112122122121221a2111222111a2001011111111111111a1110110111
011111001110111011111110111110111111a01111111110121222122212221212120212121020a111100011111110011111011222211110212101b1111101122a1211110001111111111a1001111101
111101101111101011011111111101111110a11111101101001111222111121022120011122210b211101111101101001111021112221100121121a1100111012b1111010111111100111a1111111101
111111011011011111111100101111111111a11101101001111021101020011011121012210112b001111111111111111111112101122112202010b0001112222b1210111111111111101a1111110010
111111101101111001101111111111110111a11110101111101112201212011202211202222001a011111111111110111101121120111121002101b1001112101a2211100111111111110a1110111111
