6 156
110 21
66 22
17 132
101 120
106 100
114 13
30 47
50 30
86 24
00011111100101110110110110111110001011111111111111111101111111111100111111011111a11111111011111a111111111111110010111111111011011111111a011111111111011111111111
11111111111111101011111111001101100111011111111111111001111110111111100100111111a11111011111011a101111111000110001111111011111111111111a111111110111111111111111
10111111111111011111001101101111100101111111010111101010111110111101001111111111a11101111111110a011011111111111111011011111111111010111a110011101011111111101111
11100011011111011011001011111111101010111111111111111111011111111001011111011111a11111011111111a011111001001111111010010111111110111111a111101000011111111011111
10111111111111111101101111101110111011110111111011111011010111111111101110111111a01111111111101a111111111011110001111111110010101110111a111110111111011111111111
11111111111011111111110101110111011111010111111111111011101011111101111111111101a00111111011111a110111110111111111111111111110111111011a111111011111011111110111
11101011100111101111110001111111111111101111111110110111011111101111110011101110a11001110101111a110111111101111111111011011110011111111a011111111111110111111111
01111101110111101110110111100111111111111111110111101011110111111101100111111101a01111111100011a111111111110011111111101110111111111111a111001110111111110111011
11001111111100111111110011111111111011111111111111010111011010101111111111101011a11111001010011a111011110110111111110111101010110111111a101111111110010111111110
11111111111110110111111111111111111111111111011011111110101011100111101011111111a11111111111111a011111111101111111111111110111111111111a111111111111101110111111
11111011011110111111111110111111111111111101111111111101111011111111110111111110a11101001111111a111011001111111100111111111011111111010a111111111110111100100111
11010111011111111011010111111111111101111110001101111111111111011001111111011111a11111111111111a111111111011011111111111111001011111111a111111011100011111001111
10111101111101111111101111111111100111111111111111111101111111111111111010101101a11101100110110a111110011011010111110111111110111111111a100111111111111111100011
11011111111111101111101101111111011111101111111101101111111101111110101010111111a11111010101111a001111011111111110110110111111011100111a111011111111111111001111
11111010101111111010111111110001111111011100011011110011011001111011111111010111a11101111011111a111111111010111111111111011110111111101a111110111110011110111101
11101100001110111111111111111110111111010111011101111111111111111011110011111111a11111011111111a110011011111111011111111011110111111111a111111111111111101001010
11111111011110110011111111111111111011111111011110001111110101011111111111111011a11100011101110a101111101111101101110010111110011111111a110111010101010011110011
10111111111111111111101110111111011111111101111101111111111011011111111111001110a11011011111110a111111100111011111101111111110011010120b210010220212200221221221
11101111110111111111101111001111111111111111110111111111111001111111101111111111a11111011111111a110110111111110111111111110111100111110a111021212201101220011111
11111111111111111101101111011111111101110111111101111111110111111111111010111111a10111111011111a111001111100111111111111101111101111020b002122112120221021221111
11011111111111111110101111011111111101110011011101111101011111111111111111011111a10111111011111a111111111111111101111111111101011111122b110212211011220201122111
11111110110111101111111011111101111111111111111111111111011111011101111111111111a11111010111011a011111111100111011011110111011011111201a011202010222222221112110
11111111101111111101011111111101101111100111111110101111111111011111010110111110a00111110011111a110111101111111011111111111011111001002a212111211111121121121012
aaaaaaaaaaaaaaaaaaaaaaaaaaaaaaaaaaaaaaaaaaaaaaaaaaaaaaaaaaaaaaaaaaaaaaaaaaaaaaaaa11001111111111a111111111111101111011011010111111111110a122222012021212021211021
11101111101111110111111111011111111111101011010111111011111111110100111111111101110110111111011a110111110111110111111111111111110111022a122122121221010211101011
11100100111111111111010111111010001110011101111110011111111110111011011101101110011110111111111a011101111011111001111101101111110011112a202110122211112212112222
11111101001111100011111111111111110110111101111101110111111110111111101011011101111111011111111a111111110111111111111111011110111110222b221122121012111211112212
01110111111111111101111101111110011111111111110110110111111110111001111111111000111111111101111a111111011111111111110111111011111110021b112211111022221122210121
11111001010110111011101101101110011011011101110111110101111111110111111101111110101110110111011a111111110010111111001111110111111111222a112101121011120112122111
11101100010111111111100111111111010010111101111011111101110111111111111110010111101110111110001a111110100111110110110111111011011111122a102110211210111020122001
11111011101111101110110111111111110111011111111122211221022212222201212102012210111111101111010a111111111111101101001101111110110111201b221122122011112120212012
01001111111111011011011111111111011110101101011111112012110110222222112202112211101011011010111a101111111101111101011111110111111010100b012210121210120210222221
00111111111111111111111101100111110111111011011010222111111110221210110100210011111001010011011a111111111111001111110111111111101111111a112021221021210121211112
01111111101111011111111110110001111101101111010212201112220202122022011110100211111101110111111a101110111101111111001111011111101111202b211110121222122110110201
01101011111111111101111111111111011101111111110121212020122020121212102210121100110011011111101a111111111111111011111111111101110111201a111121112012111002221202
11111001111111111011111100011111111111101101111221201112111121221212102020212011111111111111011a101110111010111111101111111110111111022b222221211122112122010021
11111110111111111111010111001011001111101110111111111111111111111110111111111101111110111111111a111011111101111111111111111111101110121a020212210212222221200021
11111011101111011111101111111101111011111011111210121100211112120010112112210111111111111111111a111111011011011111111111111100111100210a012122111101010211010101
11101110010111101101111110111111011010111110011121122201102120122222122212210111111111111111111a111101111111101101111101101101111011202b212201221212220012211221
11111110111111111111111011110111111111101010111101111121222221222121221212210210111010111110111a011111001011111011111011111111111110121a122211200221122011102222
11011001111101111111111101111101111011111111111101121100201210012220011212012111101011111111011a101111111010011101111111100110001111122a100211121121121222221210
10111111111011111110111111101011110111111111111012112220210212211111221111222211101111111111111a011101111111101110111111111111101001200b011211221210112212122110
10111101101111111111111111001111101111110101111122112122120211022102001121022211111111111111111a001111110111101101111101010111110111012b221212120210212011222011
10111111110111110101110111111001110111110111101111121201110112110222121212112111111011111011111a111111110011110111011111111111111111010b121101122111011222002212
11111110111111010111110110111111111101111111111020221122021222220012202111122200011111011101110a111110011101111111111111111111100110211a021211022021011221212101
10111001111110111111111111101011011111101101111202222122012121212002022201021100110111111010110a111111011111111111110110101111110101010a021221101211211110021120
01111111011011111111111111111111111011111111101122210111222012212211121201211110101101001111111a001101111111011111011110101111111101022a021021122021112122110121
01111111011101101111100111011111010101111111011110122111212010011120210021001111010111111110101a111011110111011111110101011111111111111b121221010211222111202210
11111111110111111010111101111010111101111111111200220201211201221121102112110200111101111100011a111111110111111110111111011110111111111a101111101111110011011111
11111101111110111110111110111111100111111111111211121112022221212102212202111101111101111111011a111110111111111101011110111111001110111a111101001011111111010001
11111110101100011111111111111120221122111212221212220112212022112220212101110111011111111111111a101111111111011111111011111110011100110a111111111111100111101111
11111101110111111101001111111120221121002112012211102001211210122222222021111011110001110101111a110111101111111101010111110110111011111a001110010101111011111111
11111111111111011111111110011122111202000102111021120112121022111011211112222001101111111101111a111111110011110111011101111011011111011a101101101011110111111110
10111111111111110111011101111011221212022212000012122020221102000102211012220010111011011110111a111111111111011110111111111111011111111a001111101101111111101111
11101101111100110011111111111020012222121121110222002112011211202100222100000211011111011110111a111011011011111111100111101111111111111a111111011110111111111111
11111110111111111111011111111101101010211011220210122202202100110221002011220001101111010111011a111110111111110111111010111110101110110a100111111101101111111111
11111110011101111111111111111110101221112221102222122022122110202121112120211101111101111111111a111111111111101111011111111111001101101a111101111111011111111111
11111101101111110100111011111022011002021202122102122011101212111122121001112110111110111011011a111110010111010111100110001001101110111a110111110101111111111111
11110101011111111001111111111121212120210212221210121212122121201122101121102211111011111111111a110101110111111111110111111111110111011a111111110101111110110111
11111111111011100111101111100121222122110012211120001121111221221202221221202211011101111001111a011111111010111111111001011101011011111a111111111110100111111110
00111111111001111111111111101122202222012010021012110201022122011011221021212211111111011111111a1111111101111111011aaaaaaaaaaaaaaaaaaaaa111111111111001111001111
01010101111111111101111010111112210102202212100221222210102011111111111111110011111011110110111a1101111110111111011a11111111110111111101011111111011101110110111
11111110011111111111111101111111211221200122021222221120201121111011111011110111111111111110101a1111101111111110110a11011111010111111101111111110111011111111110
01111101111111011011110110011022221112111222100220210122001201111011111111011111111111111111111a1111111111111111111a11111110111111011011101111111111111010111101
11111101110111110011111111111112200121121102111201122110112210011111101111110110110101011111100a1111111001111011101a01111011011011111010111111110011111110111100
11111011101110111101111111111112110121021222012222101121211201101111010110111111111110110111011a1110010111111011011a11101111011111111111111111111111111001011111
10111101111111111011100021212110101100112101221211112202112121101101100101111101110111110110111a1111111011101101111a01101100111111110111111011111111111011111011
11110111111111110111110012221122211111211112100211121211222221111011010111011111110111111111110a1111111010111111001a11011101111111111100111110011111111111111111
01110011111110111111102102101200220202121211210122112121222121111110110011011111111111101111110a1010111111111111111a11111111011001111011111011111010111111111111
01100111111111011101011222212010221112210010112122110111212011100110101111111011011111111111111a0111111011111101111a10101111111011101111110111111111111110111100
11101011101101010010110211110022102221011212222011221211212021111110111111011110100111111001111a1011101111111111111a11001101111111011111111110111011111011101101
11001101111111111001111111111220102002201222111122112112110011111101101111101111001010101111111a1111101011110101111a11101011111101111111111011111111111111101101
11111110111100111011111220121222122010111222021220221222101021101111111111011100111010101110111a1001111111010110111a01110111100111110111011110111001111111111101
11001111010111111111101022021211012202202012222121120101121110101111111011111001111111110111111a0111101111111111011a11011111111111011111111011111111111101011110
11111111011011111001112000100012211122100121201121212020212220111001111110101111110001111111111a1011111111101111111a11111101111111100011100011111111111011110111
01111101111111111111112022210111111210112202111211122221220021111111111111110111100111111111101a1111111111101111111a11111111010111101111110111001111111001101111
11011111001111111111111102210210212022211211121222011121122220111111111010111111110011110111010a0100110110100011111a01111011011111010101010001111111011100111111
01111011101011111111011111220022112101111222111120221212022121011111111110111110101111110111110a1100111101111010110a10111111111110111101111000110011111111111011
11111111110111111011100220211221212000010211120211021212100011111111101110111100111111111101111a1111111111101101011a11111111011111111111111111011110110101111011
111aaaaaaaaaaaaaaaaaaabb1012101221222021211112121bbababbabaaaaaaaaaaaaaaaaaaaaaaaaaaaaaaaa11111a0111011101111111011a11111101110101101111111011111110110111110101
111a1110111111111110111b1100212122221110112201222a101020222201111111100011111111110110111a11110aaaaaaaaaaaaaaaaaaaaa11111101111111101011111111111111111111111011
110a1111111111101011111b0221222022211210022211002b122111111111110101111111011111111111111a1111111100111111101111110111111101101110111111101111011111111101101111
011a1101111110111100012a1011122111121121111011111b222111111111101001111111101010111111101a1001111101011111111011101110110111010111110111111110111110111011111111
111a0111111111111011112a0121101200221021211220121b122101111011011010011111111111111011111a1110111110110011111111011111101111110011111011011111110111110111011011
111a1111011111111011112b2201222211211200112122201a101111111111111001111110101011110010111a1011111100111101011100111011111101011111110111011111011111101111001010
111a1111111111111111011a1220200122211222112011211b102111111111111111111011011111111111111a1111111111111101111111111011111111111111111101111111110011110011111101
111a0111110111111011111b0011211121212212120101121b002011011100110111110110110111111111000a1110111110011111011111001011111111111111111101111111111111110111111101
111a1111101111101110112b2111111212112122110010111a010111011111111111011111111111111111111a0111111111011110011011101110111110111111110101101111011111011111100010
111a0111110111111101111a1111111012011120200011202b222201101111111110010111010111011111101a0111111011111011111111110011111111111111111111101111111111111111111111
110a0111111101101101111b2221221120212010021211112b122111111111111110111110110111101011111a1100111111111110111101111110011111110111110111011111111101111101101111
110a1111100100111101112b2101110222101212012210012a012111111111111111111111111111110111111a1111101011111101111110111011011110111110110111101110011111110011111111
110a1111101111111111111a2212121210021100122111220a211201101111000110111011110110111111111a0111001111111101111111110111111110010111111111111100010111111011111111
110a1111111101011011111a2221200102121121212202111a120221101011011011111111111110111111111a1111111111101111011010111011101111110101111111011111111111011111001110
111a1011011111111111111b2122112101221222211100221b012111011111111111111001111000011001101a1101111111111001111101111011000111111111110111111110111111111111100011
111a1101110011111010111b1212211111101221211120121b001221110111101111101101111100111111101a1101101011111010111111111111101001110101111111011111111111100111111111
001a1001011101111100101a2211212112122222121210022b210121101011100111111011111111010011101a1111111111111111111111110101101111111101111111111111001101101110101111
101a1111111111111101112b1112212111111112202021112a100110000110111011011111101111111101101a1111111111011110111110111111011111111111111110111111111111011011111111
101a1111011011111110110a0222121222021011110112211b212111111110111111011101000001100110011a1110111111111111110111101101111111110011111010001111010111111111110110
110a1101011001111110111a2202112112110122111122212b020110111111111101101011101101111001111a1111111011100011110111111111111111101110110011111111110111111111111110
001a1111100101111111111a0020112010111111021101211b112121110111111111111100101010111101111a0111111011111010111111011111111101111111111110111001110011111111111111
110a1111111111111001111a1101112221101212122121022a122221011111110111111101111111111110111a1111101110101111110111011011111011111111011111010101101111101110111111
011a1111111001111110011a1102221100222112001122102a020201111111111111111011111010110101110a1111111111111111110111011110101101201210211022111221121202211111111110
111a1111111111101001111a1021202111121212222121212a121201111111100011110111011101111111111a1000110100101101111111101110111221221200102220010121201220111101111111
111a0111001111111111011a1111012111021221212200222a211201111011011101100110111111001101111a1101111111111011110110111011112202121201112222122102011210220101111111
101a1111011110011101111a0211202210021121210101201a020010110011111111011011110111101001001a1110111111111101101110011111112011101211001102211102212112222110111111
111a1111101111110001111a0211011202110022211020210a201021011011100011011000111111111111111a1011111001110011111111011110111221121200212010110221210011210111111001
100a1101111100111111111a1012212122210121211122211a110121110111100011111011111101001110011a1100111111110220122202021120112112002111212212112222121002102011111100
101a1101011110101111011a1210221102011111222120111a102021011111110111011111010111111101101a1111111111101210120111122222021122211222212102111210112111221111111011
010a1111111001111011111a1122202100222020120022121a001210110011111111101110111111110111111a1100111011221222122122120121221101121211222021212212111210122111110101
111a1111111111111111011a1100211012122221220212112b121111110101110101000110101011111111111a0101011111222111111221112210212012111122022100121111020111222111100101
111a1111100111110011111a1012120012200220122021111b211200111011011101101101111111011100111a1000111101021122101020211001002222112120202222121121121101212111101110
110a1111110111011101011a1102002102222100221110201b122111111011111111111111111111110111101a1101111101111121102002222210112222110200211201212201120102121111100101
011a0111011111111111010a0012212120101111111101211a221220101111011111111011111111111111101a1011111111121211111211121111011012201021211020112222212221002111111111
100a1111111110111111011a1220101211222201122222222b220011111111111111111111101101011110110a1101011011111211102221222122212200212112211222101110111111202111111101
111a1110001110210221120a0012220222121201121010222a120111111111111110111111101101011111011a1110001101110020222122112200011222120222111022222112121121212011101111
101a0010111012101212222a1212212110211121221010211a011110110111111111111101111101111111111a1110111111210120122112212212211102212212020021111112201111121101011111
111a0101111112221221212a1202121111122201122222222a010101110111111111111111111011110101111a1011110111112012120110120120011201011121120102111112121021212011010011
011a0110111111100210212b1201121112211011121011111a111111111110111111111111110101111110111a1100111101120110100112211121121112210101121011012221211021220111011111
111a1101111111122001201b0211111100221221012111010a011111111111011111111100111101111101111a1111111110200202201122222122201222201220212012201221201111210111101110
110a1111111112222110011b1112210012110012222011111a101110101111110110111110111111111111111a1111111110002122221022220201022102100122111122202221112102212011111111
