29 16
107 158
41 69
113 98
100 121
51 49
63 25
67 22
24 66
45 150
10100111111101110001a111111100111111101111111111111111a111110110111111011110010a01011010111111111111101111111011111111111111111011001010111111101110101111111011
00111111111110111111a011011011111111001101110101101111a111101001111111101111001a00111110110111011001111110011110111101011111110111111111111111110110101111100011
11111011111010111101a111111010111100011110111110111111a111011111111111111111011a01101111101011111111100111111111011011111101010111111011111111011110011111101111
11111111101111011110a111010110111111001011101100011110a111111110111101110110101a11111110111111111110111101111110111101011111111111110010111111111111111111111111
11111111010111111110a001111111111111101111101010111111a001110011101011111111111a11111110111100111110010011110010111010011110111110101101111111000110111111111101
10111110101111101111a110111011110111011111111011111110a111110001111111111111111a11111110110110111111111111100110111001101111111111111111111011111111110011101111
11111111111110111111a111111111111111110111001110110101a011110001101111111111111a11111011011111011001111111111111101111111101111111111111110111111111111111011111
11111110111111111111a111111111100111011111101111111111a111111001111111011111101aaaaaaaaaaaaaaaaaaaaaaaaaaaaaaaaaaaaaaaaaaaaaaaaaaaaaaaaaaaaa10111111111111111111
01111110101111101111a111011101010111111110111111001111a111101111101110110111110111011111101111111110011111011111111011100111110011111111111a11111101111110001011
11111111111111111110a111011001010111101111111111111111a011111111111110110011111111101111011111111101011011010110011110111111111011100011111a11111111011101101111
10111111111111111111a011001111111111100101111111011011a111110101111101111001011111110011110101101101111111111111111010111010111100001011111a11111111111111111101
11111101111101111001a111100011111111111110111101011101a110110111011101111110111111111101100110110010100111101111111101110111111111111111111a11111101110010011111
11110111101111101111a110101111001111111111111100101111a111110111101111101111110111101111100111011111101111101111111001111110111111111111110a11101011111110111110
00111100110100111011a110011111010101001111111011110101a110010111111010111011111110111001111001011111111110001111001111110101111011111111110a11111111110110110111
11111111101110111011a111101111111111101111111110111111a011101010011101111111111011111111100111111101110110111111101111101111011111110110011a11101011111111011101
11111111111110011100a111111110111110100110111011001111a110110110111111111111111101111111111111101111110111111011111111011110111101110111011a11111110111111011011
11111011111110111111a011011111111111101110011101010111a101111111111111111111111111111110111111110111111111101011111111111101111101011110111a10111111111101011111
11111111110011111111a110110110111111011111011011111011a001001111101111111111111111111111111111111110111111011111111101111111111111111110111a11011111111111110111
11111110111101111111a111111111111101111111011000101111a111111110101101011011111111111111111010111101111111111111111111110101101111111111001a11101011100010111111
11111111111111111010a001101101100111111111110111111111a111110111101111111111011011111011110111111011111111001010111101101101111111111111111a11110111110001111111
10001010011111110111a111010110111111101110011001100110a010101010111011111110111110101111111111011101111011110111111011110111110111111111110a01010111111111101011
11001011011111111000a111101101111101111010111111100110a001101111111111111111101011111110110111111111111011011111010111110110010111111101111a00111101111111111110
11110111111111111111a111100111001101111110110001001011a111111011010101111111111111110111110111111101111111101111111111001111100111101111110a10111101111111011111
01111111111010111101a011111011011111111011011011111111a111110101111110011101100100110111101001111111111111101111001110110111101111011111111a01011101011011111111
01111111110101101101a111111011111001110111111111111110a101010111112101111222221111111212211220220111111111111100101110101001111111111110111a11001111101111111111
11111111111011010111a111111111111111111111010111110111a111110111110121202111212022211222121110211111111111111111111111111110111111111101101a11111111111111101111
11111111101111100111a100111111111101101110111111101101a101111011112210012110212212112102010211122101111110111110111111111111111111101111111a11110111110111111111
11111111110111100110a111111111111111111111111110111111a0111011110102102222022121110222102201212221101101011111111110111aaaaaaaaaaaaaaaaaaaaa11100111111011110110
10101111111111111111a110011110111111111111000101110110a1101111101121221112121212112202222121222121111111111111110011101a1110111111011011100111111011111010111111
11111100110111101111a111111110011110101110111111111011a1111111101112021111022020101001112121112221111111111011101010110a1111111111111110111101101101101110111111
10101111011111111111a101111111100111100111111001111101a1110110111102100211201112212010212102211011111110111011111011111a1111110110110101111111101001110000010111
10101100111101111100a011111111111111111111101011110111a1110111101111212121201200210202122101121221111001111111011111101a1100110111111110111100101111100111111111
10110101001111111111a111001111111111111110111011111110a0111011101021021202101120202021211022111211111111011111111101101a1111111111010111111111110111110111101111
11101111111011011111a101111101111010011011111111111111a1111110111012121010221211202010122101112211111111100111111011111a1110111101101000011111010101110111111111
11111111111101101111a111110111100100111101111101111111a1101111010100221122120121211112221110111011100010110101101101111a0111100111111111101111111011111111111101
11101101111111101111a111111011111111011111111111101101a1011100101020021101112000100110222021021011110111011110110111111a1110111111011101011111110111110011001110
11111111010110101011a111111111101111111011110101111111a1111110101121122120111111122222211122121111111101111111001111110a0111101111111111011101111101011111011101
10010001010011011111a111110011011011011111110111111101a1111011111120212211120221120210212120212120011111101111111011011a1011111111100111101111101011101111111100
11101111111011011111a110011111011111110111011110101111a1111110101122020222001121121002220022221221111011111111101111111a1111111111111010111110111101101101111111
10111010111011111111a011011011111111111111011111111111a1111011110112202200201202110112110110022011111111101101111011011a1111000111111101100111101111111111101011
11101011111110111111a111111101011110111111011111111110a0110111111120212212020102001221222212202210010111111111101000111a1111110111111110111111010111101110011111
11101111110111111111a111111111110111101101001101111111a1011110111111110222221012121211110121120201110111111111111110111a1111111111110111111101101111111110111111
10111111001111111011a111001111111110101100011111100111a1011101111122121021121222221202112022221000211001111111101001111a1111111000011111111111101111111110100011
10010011111111101111a111111111111111110101101011110111a1111101111112222111111021112211121220111210201110111011111101101a1111101011110111011111101001110101101110
01111010101110110111a111010111111101111111111011111011a1101111100002100202201120102220112122112012120101111111111101101a0100111011011011101111111011111111111111
11110111111111101111a110111110011110111111101101100111a1111101101020002221100120222102100012102012121111111110111110110a1111111110111110111111001111011102112122
01101111111110111101a011011111101101111111111110111101a1001111111011211121022121211100211112222202110111111111011110111a1111111101111001011111011111111222211112
11111110110111111111a111111011111111111011111111111111a1111011111121220120202212121111102202001121011011111111110111110aaaaaaaaaaaaaaaaaaaaaaaaaaaaaaaabbbababbb
11111110111011110111a100111111001101101111101111111101a111111110111221102201201201102122102022022011101110111010111111000111111111111101111011111011112111012102
10111010111111111110a111111111011111110011101111101111a111110101111101221201120202021222221120112222111110101111111011111101101101111111111111011111111202021201
11111110011111111111a111111111011111110111101111111111a111010111110121122211120110001121212022120222111011110011111111111111111101111111111111110110110122010222
11111111111111101110a111110111001110010111011111022122a111222211222021112001211220210010120022222220111001111110111110111110111111111100111111101111111012000121
01101110101110111101a111111110111110111111111011122122a021220110212121212221202222211012011112110111100111100110111111111111111111101111111010100111111102212012
11110011110111101111a111110110111111111111111111112110a022112210111110211011010011100110001111111210110011111111111111110110111011111111111111111111011112212211
11111011110010111011a011111010111111111011100101121120b212102122101120102122112112122201010212222012111111111111101111111111101111111111011100010111111222220221
11111011111010111111a111111101111111101111011111111221b001120222211012210121202000202110000021121221111111111111111111101001111111111111110110111111112011212010
11111111011110111011a111100101111111111111011111112022a211202201212212111220111112121200211120111111111110111111111011101101111101111111111101111111112202220002
11111111101111111111a111111101101111111111010101112112a111221102202221012221110102211010120112001011101111111001111111111110111101101111111111111111112020110221
11111111111001111111a110111011111111111111010110111201a111221112101112122211121122111111222210111221011111110111111111101111011100110110111111111110101201211200
01010111111110111111a011101111011011010111111111112220a022212111222212211121210111021111221021210201101111110000111111111111101111111101111111111110111112222122
10111111111111111101a1110111001111aaaaaaaaaaaaaaabbbbaa222212121222011122221122212200112102110210021010111111111001111101000101111111111101111111101011110222212
00101011111111111111a1111110111111a11011101111111110120222120222221011201001212220211222210112222120111111101011111101111111111011101111111111110111012211210021
01011011011111110111a0100110111111a11010111001111101221221121112122212221012210020221102111102021122101111001011111111011111011111100110111111001101112102121122
11111101001111111111a1101111212201a02210102212111212112011012221112220222220020202120110020021011011111111111111101111110110111111101110110111110011011021201122
01111101011110011111a1010111101212b11021210202212201120020101212202201122112212112122210212102022222010011110111111110111111111110111111111010001111111221210011
11111111110111111111a1011111111011a20222222022122211212221221211210121010112021121211212222210111221111001111111111101111001111110110111101111111111012201121020
11111110111001111111a1111001111111b21021200201111121110201111201122121122110001210121212212112022111111110111101111011111111111011111100110101101011111121112120
10111100011111111110a1010111010111a12212212122120112110011121212111111212111111101020121022212221222001101111010101111111011111111001111111011011001102102222022
10111111011111011111a1220112122221b02021121020020101111121000121221012102211011210122211110010222212111011101101001101110111111111111111111111111111112122102222
11111111111011101111a1210122202021b21101011121100211022222021112221210020122212210100112122202122212001111110111111111111111111101100110110111011111110222121112
11111111110111111111a1110112221021a22222020211011110222012221222222210101012200212212221001111202211111111111111111111111111111101110110111111100111112000110010
11111011111101110011a1211120021121b22210021220100210022211112212110011221210110220112012210121112212111011111111111001100011111110111011101110011111111021101210
11100111111111011011a1101011111001a22211221220220222102221110201021222221122122211111111110100111111110111111111111101011111110111111111101010001111101120202211
11101110111111111111a1222111222100b20021210100111212121102221221011020002021221011101111111111111010111111011111111111111101111111110110111110111011011221201112
11110111101111011111a1122102210212a10121011211211122102111211120222002022102202111011111111111111111111011011010111111101101111101101111110101111111112120001200
11111111111110001111a1101122111112b02221012110121122212210002212212020122210111011111101101111110101111110111101011111110111111011101100111111010111101212222022
11111111111111000101a1122220101000b01120122121202222122102201211102211111012202111111010011010011111101101111111111100111011101101011111111011011111111111011101
11111010110111111110a1021010212211a21112022221110221010020111020222222102120221011111111011111111110110011111111111111111111101111111111011111110111111111111111
11011011011101111111a1112220202222b21222021012111012112122022220112221111221001110011111110011111011111111111111111111111111111101110111111111111111111011111111
11111101101011110111a1212112120222a10012122111212101211120122122122120221122001211110111111010110111110111111011111111011011010111111111101110110111011110111111
11111101010111101111a0211112221222a21212202120111211111012010120111202222012221111011011111111111111111111111111111011100111111111111110111101111111111111101011
01101111110110111111a1010211120222a22221221221111222012122212111221211110122110211111110011111111101110100101100111111111111100111101111111101101111111111111010
11111111110111010111a1122121222102a22112222002211222111201111111101110110111010011101011111111001111111111111111111111111101011110111011111111101111110011111111
11011011010111110111a1221111011200b11221212111011121112201010100101101111101111010111110111110111011101111111101110100110111100111111011111111111001111111101011
aaaaaaaaaaaaaaaaaaaaa0011111110101b22121112102012121220011110111110100111111111111111111111110111111011111111111101101110111101111011111011111111111111101110111
0110111001111010111111011111101110a10122112012222101010201110111111011111111111111011111101101111101010111101101101110111001011101101111111010111001111110101111
0111110111111110111111220101102121a11101201020122111111011111111111110111111111111111110111101011110111111111101111111110111101011111101111111111010111111111111
1111110011000001011110011101011111a12110001110101111212210101111011100010110011101111111111111111110111111111011110011110110110011001111101110010011001111110011
1111111111111110111110201112101102a20221010122221221211211111111010110101111011110110101011111101111110111011111111110001110011101111111111110111111111011001110
1111101111111111001111111001110101a11120212220011120011211010101111111111111110010111111011111111111111110101111111100110110111110111011101110110111111010011111
0111111111111111101111110110111111b22122120120211221221011111111011111101111011110111110100001111111100110011101100111111011011011100111110101111111110011110111
1100110111111111110011220012212011b21210110111212202221201110111011111111111101110011110111111111111111110110101111111011101101111110101001101111101111100111110
0011011111101111110111111111110100a12121001101011111111111110011111111111101111011011111111011011111110111111111010111101111011111001110110111010110111111111110
1110111110011111111111212212021221b10001111122222102211111111111101011111111111101111111111110111111111001011111111111100111111101011111111111011111110011111111
1111111111011101011111111212222211b11211111112222101211111111101101111111111110101111111111111111101111111100110011111101111111101011110111011111111111111011101
0110111101001111111111221012211211a20121111022222211011111111111111011101111111111001101111111111111111111011110111110111111001111111101011111111011111011110111
1111111111111111111111112110112200a22110122212212221211111110111110011111111111111101110110101110110101101111011111101011111101101111111111111111111010111111110
1101111101111111111011122101211200a21011021200220021211111111111111001111111111101101011111101111111001111111001101011111100111111111111111111111110111111111111
1111011111110111111111111111111111a10111111111101101111000111101111101010101111111110110100111101110100101011111110011101111111011101110111111101011111111011111
1110001101111110011011111111111111a101101111111011101110aaaaaaaaaaaaaaaaaaaaaaaaaaaaaaaaaaaaaaaaaaaaaaaaaaaaaaaaaaaaaaaaaaaaaaaaaaaaaaaaaaaaaaaaaaaaaaaaaaaaa101
aaaaaaaaaaaaaaaaaaaaaaaaaaaaaaaaaaa011010111111111111011a111111111111111111011111111111101111001111011101111111001111101121221202101021122120122111112001110a011
10011101111111111110011101111011011011001111001111110101a110101110111110111110101111111011101111111011011111011111111001112021121212121112202201201112011111a110
11011101011011011111111111100101111011111101111111011110a111111111111011011111101111011001111101101011111101111101111111121110122112121201102212111212121111a111
00111011111111111111111111011011111111111111111101111111a110111111111100111110111111010111111111001110010111111111011111101221110000021112212121010221210111a111
11111011111111111111011011101101011010001000101111111101a111111111111111101110110100101111010100110111101101111110111011121210201211002112212202212211021111a111
11100111001110111110111101111111111111101010110111110110a111111111111110111111111110101111111001111111110111001101111110121110222202122222212220222121121111a110
11011111111111111111011111111110111111111010111111111101a111111111101111101111111111111101111111101111111111111111111111121112020112112112222221112112011011a101
11111110111111111111110010111111101111011111111111111111a011111101110111101101110111111000101101111110111011111111101111121122111020021211102121121211121111a111
11011110101110111101011111111001111101001111110101011101a111111101111111111111100011101011111101111100011111111110101011112122020220102212212222111212121111a111
11110111111111101111111111101101011111011111111111110111a001111111011111001111111101111111111110111011110111110010111101112211110201220011112121022111211101a111
10001111011110101111111011110011001111110011111111111111a111110111101111110111111111111001000101011110111111111101111011011022122112220222121102020120011010a110
11011011111111001111110111110111111110111111010011111111a101111111011111111101110101111111110101101011111111111111101111112111122102211112201202121210011110a111
11111101110111011111101110111110110011111100111111111111a111111111100111110110111111011111111101111010111011101111111101111102120121111201112122102221211111a111
11110111101110011011111111011111111111101101111111111111a111111110110111111011110111111111111111111200202211111211111112222110211201111121101212212122010111a111
01111010111011101111101111110101011101111111111101111111a111111111110111111111111010101111101101011222112111221122122111122222222112121201121212122012210011a111
11111011011111111111010011101111101011011111111110111110a101111111011111110011101111111111111111101212122121221201220121021211211011221102012221101100001110a111
11011111101111111111111001011111101001101111111111111111a101111111111111111111111111110111110110011211211012211210221201211222212110211211211222222012201110a111
10111111101101111111111111111101010101111111111011111111a011111110101101111101001101101101111101110102112210121201120212222120222111212222222020220000221111a111
11111101100111111011111011111101111101010101110111101111a111111011011011111111110011001011111111112221111212011212110211111211010122202020200212012220121001a111
01111001111111101111101111111111111111111111110111111111a111110111101111101111110001111111111111112022211211002202222121010012111211121222211121212122110011a111
