29 7
108 151
22 151
26 3
44 87
78 52
27 123
98 92
19 37
25 102
1100111110101111001111111111111111111111011a10101010111101011101110110111111111111110111110110111011110a00110111011011111011111111011111111111011111100101111110
1111111111111001111111101011111111111111111a11110111111101001111001111111100110111101111111111111101110a11110011000111100111111111111111111111111110011101111111
1110111111111111110111111101111111010111111a01101111111001011111110010111011110011001111111110110011111a11111111110110000100110111111111101011011110101101111111
1011111110110111011010011101111111111011111a11101111111011100111111111001101111110101101111111111110101a11110011010101100110111111111111101001111010111111111110
1101111011101111110111101111110111101111111a11011111111111111111111101011111101111111111110111111111111a10111111111111101101111111111111110101111110011011111111
1111100111101011111111100111011111111011111a11111111111111111111111111011111111111111111010111011110110a01111111111101011111111111011010111111111111111011111010
1110101111101101100111111111011011011111111a11011111100111101111111111111100111111111011111100011111011a11110111101110111111111110111111101111111110101111111111
0110101111100111110111111011011111111110001a10111111111110111011110111111111011111110111111101101011011a11111001111111111111111111011111111111001111111100111111
1001111111111110111101011011101111111110111a11011100011011111111111111011111110111111111111001111111011a11111111101010110101110110111011101111111101111011111111
1110111111111111111111111111110100111111111a01111111101111111111111110101111111111110111110111111111001a11111111011111111111011101101111111111111111111111111111
0110111111011110111011111111011111111100101a11011100111101100110111111111111110110111111111011111111011a00100111111111110111111111111110111101010111111110001110
1111111001110011110101111110111101011111111a01111110011001101100100111110101101110001110111111111011110a11101111111101011011111111111001111111111110111110111011
1011111101011111111111111110111111111111111a11111110111111101100111111111111111110101111110011111110111a01110111111111111111111111111110111101001110111111111001
1111111111101111111111111111111111111011111a11111011110011101111111011111110101011011001111101011011111a11111111111111111110111111111111011010111111101111110000
1111110010111111110111110001010111111111101a11111111101110111101111100111011011111111111011110111111111a11011010111111111011110111101111101111111011111111111111
1111111111111111111011101111000101111110110a11111110111111101101111111111101110111011011110010011110111a11111110111111111111110001111111100110011011111011101111
0110111011110011100111110111111111100111111a10110111011101100111001101001111101001111011111110010111011a10100011111001111111111111111111111010111011011111111111
1111111101101111111011111111111011111010111a10111111101111111111111110011111111111110110111011111111101a11110100111111110111110101100110111111110111110110111111
1011111111101011101011100111011011011110111a10110111111010111111111010111101111011111011111111111110111a11111110111111111110110111111111011111101111011110111110
1111110111111111011111111111111111110121011b10222021121221202012210211010001111101111111110111110011101a01101001111111111100111011111111101111111111100111111111
1101111111111111111111100101111111111122211ababbbabaaaaaabaaaaaaaaaaaaaaaaaaaaaaaaaaaaaaaaaaaaaaaaaaaaaa10111111111101011110111101111011111111100111011100110111
0101111111001011111101111100111011001222122202110012122011222220121211110111011100111111011111101001111111111111111011011111111110111110111110111101011111111111
1101111111010100111111111011111011111202021102102112012122011211211211110111101101111110111010111011111111111111110111111000111111111111110111111101111211111122
1111001111111110011111110111111111111121221120221102102011201202221201110100101111111111111010111100101111010111011011111111011111111111111111101001111022120210
101011111111111111011110101110101100012ababbabaabbbbabaabbbbbbabbbbbaaaaaaaaaaaaaaaaaaaaaaaaaaaaaaaaaaaaaaaaaaaaaaaaaaaaaaaaaaaaaaaaaaaaaaaaaaaaaaaaaaabbbbbaabb
011011111111111011111101110110111101121a210111101222222121122202200211011101110111011111111111111110111010110120112222211122222212021110101111100111001211121122
111022111022222212202222120211211211122a211211210012101101220122122110111101011111101101111011110101111222201221022211202200200222201111111111111111111121201221
111121220122112121112211121221011211121b222222202202122100120111121210111110101111111111111010111001111011121112111202111012121020011020100121201011222220110122
011002022222212102112011211210122111120b221122101111122220210202022011110101111111111110110111111101112111111021122201112111120122120220112111110121010222222221
001201011211210111111210221202211111110a122010122112222220010011121111011111111011111111111111111010001111011211012221121000200112020221122121122012022211112221
111102121012102111122212010011122111001a220021221221121110022112101111111111111111111111111111101111012120002212212001222102122120221212111100102211222121122122
110000110222111021011000021110020211102b201201021211201002020222011110111111111111110100111111111111111221220120111211121121110101210121122121112012122111210021
111111222122211121122111101222221200112a112120112122111111212122211111111111111101111111111010111011112211112012211012221022110120212210111010021110111102222022
011111112221220022101111211201010211121b011200111210100221210220111011111111111101111111111111011111010010021012222221212001021211121012122122112121222120111212
111100010120121212211210220110121000011b221121220021110112212221120111011111011101110010011000101111112022121012222102100112102122011221122120112110122202011121
111211111212221112111102000102211111102b112221121101022010021121001210111001111111101011111111111111110222122120220102121122122122221022111011111022012002111201
111222202100112220122121111012111110110b212212112210211212022211121001111110101111111110111111110110111211221021211112022222212102020111121110212001220112021112
011100202211211112121120211111021211021b212221212011221221021210000011101011111111111111111111101111112221110122111022012121121222202012111122211222212220121202
101012121111122021010221000102212201121b121112202112212212121222220111110101001100101111110111111011112210211222112122101211120202221112112121110010221111221122
111001200211012122222022211112100010121a111201111212221001222022220111111100111111110110111101111111111111001101122201221121201012202211111121121222022212112220
110211101122020021010020121111101111101b212212221122222121220110222111110111111111111111111101110110012211210212122021221122011111120221011112202222022122020111
111110112121111211110122110121222211122a112212211010012212012110212201101111011111010111010111111111112011211121112121211100220221201101122122211222222122111210
111011220111210201200222111011121111111b111122120120221212221122121010110110111111110110111110110000111221012222121000222212210122121121110110111001001001111111
111102222221210212022212012212110111121b111120110122121001212211202111101011111111111110101111110111112122220212122112102212212202112111021211211212211121222022
111201120000211020112221022211221011021b211211111222012220210200001201111101111111111100121100101200111221021101121221222122121121111222112101021221210011102001
110102112002110121111101211012201111112b101211121102212011002122221011000111111111111110212112200221111021211121111202222212222121111112121121222101222112212221
101221221110221112222110222201110111101b110202212222211222112222111111011111111111110111001020110202112210111222122122101020011210221122122121222222222112210122
111122112101011212200222111121222001122b211102211101220120122121120011111101011110101101201222022211102212002221121220022212221211211222122aaababbaababaabbaabbb
111020111202121211222011210212021111110b212112111021212111022011012011111100011101111112121102121122121221222201020121201222120121221002111a10212221122212222102
111021010200122022211011100202221111012b111210121001111101212210221111111111111111011111222110111211112111122121121120212012212222111122122a22022222222000210211
111011021222021010211112212220220210110a111111111110111101111011111111111111111111101111222122222222112120112012122111111111212222220121101b22122120112110110011
111112112121222102211220122120021111101a110111111111111001100111101111110111011001111112122000120211111022121110121212121210222121210221101b02202112102121101111
111220011222212102121122121111210210111a110011111111111111111111111011111111101110111111222212220222011221222102110111211110110211201212110a21222022221212201211
101222111000222100121122112212112210111a111111011111110111111111110101111111110111101012201111120122121212001212002112111212110201212212020b02202220220122111011
011001202112222102001221220201110110110a110011111111011110111101111101011111111111011010221110201112110120221012021022111111010101011210120b01112112112222111111
110012220211222021112102011121222110111a011111111001111111111011011101011110111111111110121121212120121202112211122212122111212100021221000b12022022022200100110
111011212121111112112202211221111211111a101101111101111011111011011111101111011110111001011122202012122021121221122212111111211022122101000a00111122012112110101
111111111011111111111011101011101111111a111110111011111111111111111111111111111010110112222021221102021101221101121221111112221212221211110b12110202121111011111
111101001111111111011001111111111101111a101111110011101111101111101101111111111110101110222022202220122222222022112221111111011111110101000a11111110010101111101
111101111111101101111110011101111001110a11010111111111111101111111110101111010011111aaabaaabbaaabbaaabaaabaababbababaaaaaaaaa11101111011001a11110001111111110111
111111110011101111111111111011111111111a01011110010101111111111111111011011111111111a111122212222112021101211212112120001011a11111101111111a11111001111111111111
111111011101110111111011011101111011111a11111110101111111111111111111000101111101110a110200101122222120212111121111212111101a01101111111101a11110101111111100111
111111010110111010111111111010111111101a11110110111110001011111101101111111100001110a112202211210111122121201011111102111011a11111010111111a11111111001111101111
011101101011111101111111111111111101111a11111111011101110101011101011111111100110111a112021121212222122101022010101101111111a11100111101101a11101111011011111111
1101111010110111011aaaaaaaaaaaaaaaaaaaaa11011111101111111111111110111111011111101111a111100121111122112012221012110222011000a11110111111111a11011111111111111001
0101011111111011111a1110011110101101111011111100111111111111111011111111110110011101a102110101201211011201212212101122011000a11011111100111a11111011100111111101
1111111111111011111a1111111111111111101111110111111111111111111111111111110111111111a112211222220121122211221212102022111011a11001101111111a11111111111111101011
0110111110111100110a0111111101001111011101111111101111111101111101110110111000111101a111222111212122011121210102102201111111a11111111110110a11111111110111111111
1111111111001111111a1111111111001111111111101111111111101101110111111100101101110011a111220122201201022112112102121112111011a11111111110111a11001110111111111110
0011101011001110111a1101111111011111111110101111111011111111101110011111110100001110a101122221222212112022222202122112110111a11101111111011a11010011010101101101
1011101010111111011a0111101111011001101111110100011011010111011111111101111011111111a112122211210122122111121122111212111111a11000101111111a11101111111111101111
1111111101111110111a1111111111001011111111011110111110111111111110101111111111100111a112211201012221110211210111112120111011a11101111111111a11100111110101101111
1101110111011101111a0111111110101111111110110101111111111111110111111111110101111111a111201122010221121211102220122201011011a11111111101011a11111111111111110111
0111111111011011111a1111001111111111111111110110111001101100100111111101111101111011a112220112121200111022210221011121111010a11110111111011a11110111101111100111
1001101111111111011a1110011111110101111111111111110101111111111111111111111101011011a111020101220112111221112200122122111111a11111101111111a11110010011110111111
1111111011111111110a1111111101101101011111110111000101001111111111101111110010101111a001111111101111111111111001111001011111a11110010111111a11111111101111111100
0111111111100110011a1111100101111101110101111111111111011111111101101111111010110101a101111110110111111111011011101010111111a01100101111001a10111111111111111110
1101111111111001110a1111111011101110101111011111110111111011011111111111111100111110a111101111111111111111011010111111010111a00010011111111a11101111110111111111
1101101110111111011a1111101011111110011011111111011000000100022012001220121012012121a101111001111101111101111111111110101110a11111011110010a11111111111111111100
0111111111110111111a0110110111111101111101110101110111001111111111111011111011111101a111111111111111111111110110000100111101a11101111111101a11111111101101111111
0111111111111111011a1111111111111011111111010100010102222112211121212001222111112111a111111111010011111111100111111101111011a11100011111111a01111111001111100111
1111111111110011010a0111101110000111011111111111111002121022212111122112122202211121a010011111111100101111111110011011111111a11111011111011a11110111011110001111
1111110001111011111a1110111011111111111111101110111102211211022112100211002211212021a111010101111110110011111111001110111111a01101111011111a11111111111111111110
1111101011111101111a1111111111111111111111111101101112222211111121222012202222110121a111111110001111111111101111100101011011a10111111101111a11101111111111101111
1111101111110111111aaaaaaaaaaaaaaaaaaaaa11111111011112012210211101211011222210121121a110111110010101111111111101111101110111a11111111010111a00111111110111011010
111100101111110111001011110011111111101a11110111111121122221122000102122121222021121a101110101110111111111111011101111111110a11100111101111a11111101011101111111
110011111111011110011111111111100011011a11111101011102121102212211121110012211222021a111011110111111111001111010111111111011a11111111111111a11111011111111101111
111111100101111011101101011111111011111a11111101111111112200211221112111222210012111a111100111011111011011100101110111111101a11110111111111a11101101101111110101
101111011111110001111101101111111111111a01110101111111001220022102120012122000221111a111111111111011011110111111111101111111a11110111001110a11110111011110111111
111111111100011111110101110110111011100a11111111111101222120021221022022120222122121a111111101101111111111111110111111110111a11111111001011a11111111101111111111
101111101111101011111111111111111111011a10111011110011222011222211100111001112122121a101111111011111111111011011011111110011a11111111111001a11011101111111101011
111111110111111111111111011111110110111a11111111011121210021211212220022111022220020a100111111111011111111111111111101111100a11111111111011a11111110111111011111
110111111111111010110110111111111111110a10011111111100121121212022112211121211111021a011101111101011111011101111110011000111a11111101011111a11110101110111111010
011111010110111111111110111111101101111a11111010101010102221102011221211122222002111a111111111101101101110101111111111100110a01010111011111a11111100011101110101
111111111111111010110011001111011010011a11110011111110222100101221111211002221122011a111111011111011111111011111111101111111a11111111110010a11111111101111101111
011111111110110101111111111111111111111a01101101011021011120200112122212011111120111a111011111011111111111011100111101101111a11111111111011a11010001111011111111
101110110111101101111111111111110111111a10111111101112100211222120012121010221112011a010011011100111101100101110101011111111a11000111111101a11011111110110111111
111111111110101011110001001111101111111a01111011100121210022022200002111012121122121a011011110111101111010111111110101101111a11110001111101a11101111011111111101
110111111111111111100110111101110011101a01110111111112212201112110220121121011100121a110101112122220102222211210100221122101a11101111111001a01111010111101111011
111111011111111111100011111111111111010a11111111111121022010112001112222102110211101a111111122110201110111111010101111101011a01011111110111a11110111111101111111
111111111111111111111111110001101101111a11111111111021021021012212222121221122220121a100111111221102212111111222120121120011a11111011111111a11111111111011111111
001101111111111111101101111111111011100a11011111010121111112212101201122021220012111a111101121122102212211122201110022011101a11011110111110a10011101110111110101
011111111111111011110111110011111111111a11111111101102112211111022121021212020102111a100111112202110112212111112120222201201a01111111111111a11000100111110011111
011111111110011011111111101101111110101a11111101111112002221210111121212112100202110a011111121221020222222122122012112111111a11111111011111a01111111011111111101
1111111011111011110aaaaaaaaaaaaaaaaaaaaa11110010101122202222101102020021002102002101a111101122112112021021022121112122211121a11111111111111a11111100111111111001
0111111111101101101a1111111111101011111111111111111021122212121010221201102022111100a011011120221221212211220211110221201201a11111111111110a01011101011111111111
1110010111111101100a1111111101111100101111110111100112222212122212212112120101200111a101111122111121220100022211111122120111a01111111111110a11111111111111100001
1111101111101111111a1111111111111111111111111110111111110121212200112112120121200121a111011000112022022101102222000000121120a11111010111111aaaaaaaaaaaaaaaaaaaaa
1101111111110111111a1110101101101010111101111111111121221021022121120220201201212121a111101012212120010002222210121021121220a11110111111110101111010111111110111
1111111011111001111a0011110011111100011111110100101101100110011110101111111111111100a011111112101222222112002120122211111221a11111111011101011011111111111001011
1011111011111111101a1111111001101111110010101111111110011011101111111111011111101111a111111111111121101122220022112121110021a01111111110110111111111101110111111
1101111111101011110a1011011101110101010111011111101101101111101111111111110111111110a011111110112022110210022222121111011211a11111100111010111011011111111011111
1011001111111011101a1111011111111111011111111011111110110110111110110111111101010111a011101112211211121022220212101120101021a11111110111111101110000011111011111
1111010101110110110a1111111101110011110011111111001111110011111111010001111111010111a010101021000122110122211121121010221211a11111110110111110110010111101101111
0110001111111111111a1101111111111111111011111111100111111111011110010111010111000111a100111012221022011221012210120201211121a10111111111111001111111110011111110
1111011111100101101a0010100110111111011110111111111011111111111101111011011111111111a010100112220211212200222022121001121021a11011111101111111111101111101111111
1111111111110111110a1111111111111110111100100101011101101110101101111110111111111110a111111020212201122011002221112001211221a00111011101110110110111000111100110
1111111111011011001a1001111111111011111111100110110011101110111111111111101111101111a111111120111122221011122221110111201111a11111111111111111111111110111101110
1011101111111111111a1101011111110111110111111111011011110011110111011111111111111011a111111101011011022012201222120021211001a11111111001110111111111111011101100
1111001101111011111a1110111111101001111111111111110110111011111111110101010010111111a001111101212110122002021212120212001121a11111111111110111110111110111111011
